CTAGTGAGTAGCGCAA-1	Myeloid
CGTGAGCGTTAAGTAG-1	Myeloid
CTGTTTATCTGGCGAC-1	Myeloid
CACAGTAGTCGCGTGT-1	Myeloid
TAGTTGGAGTCGCCGT-1	Myeloid
CACATTTCAGGCTGAA-1	Myeloid
GACGCGTCACACCGCA-1	Myeloid
GGCTGGTCAACCGCCA-1	Myeloid
CGTCTACCATACGCTA-1	Myeloid
AGGTCCGGTTAGGGTG-1	Myeloid
CTACGTCAGTCCGTAT-1	Myeloid
AGACGTTTCTTAACCT-1	Myeloid
TCTCTAATCGGCTACG-1	Myeloid
CCTTCGATCTATCGCC-1	Myeloid
CTCAGAACACATCTTT-1	Myeloid
CGAGAAGTCCACTGGG-1	Myeloid
AACTTTCAGCTCCTTC-1	Myeloid
CACACTCAGCAGCGTA-1	Myeloid
TGCACCTCAGACAAAT-1	Myeloid
ACTATCTCACGACGAA-1	Myeloid
CGCGGTATCAACCAAC-1	Myeloid
CAACCAAAGTGGAGAA-1	Myeloid
TGACTTTTCATAACCG-1	Myeloid
TCGGGACGTCGCATCG-1	Myeloid
GATTCAGTCGCCGTGA-1	Myeloid
TCATTTGAGCTACCTA-1	Myeloid
GAACATCAGAGATGAG-1	Myeloid
CCTTCGACATGAGCGA-1	Myeloid
ATGTGTGCATAAGACA-1	Myeloid
AAAGTAGCAATCGGTT-1	Myeloid
GACCAATAGGACGAAA-1	Myeloid
AGCATACAGCTACCGC-1	Myeloid
CTCATTAGTTGTCGCG-1	Myeloid
TGCTACCAGCCGATTT-1	Myeloid
GCTCCTATCAGGCAAG-1	Myeloid
TAGTTGGAGCTAGGCA-1	Myeloid
ATCATGGTCAGTTAGC-1	Myeloid
AACTCCCAGTCAAGGC-1	Myeloid
GCATGATGTCATGCCG-1	Myeloid
GGACATTTCCTGTACC-1	Myeloid
AGTGTCACATCAGTAC-1	Myeloid
GGGACCTTCTGATTCT-1	Myeloid
AACACGTTCTCAACTT-1	Myeloid
CCTCTGATCCGTCAAA-1	Myeloid
CGCGGTACACCAACCG-1	Myeloid
GCGCGATAGTTCGATC-1	Myeloid
AGTCTTTTCCTTGCCA-1	Myeloid
AGGTCCGCAGGCGATA-1	Myeloid
CCGGTAGTCGTGGTCG-1	Myeloid
CTGCTGTTCAGGCCCA-1	Myeloid
GATTCAGTCGTAGATC-1	Myeloid
TCACGAAAGACTCGGA-1	Myeloid
GACAGAGTCAAACCGT-1	Myeloid
TACAGTGTCCACGAAT-1	Myeloid
AAGACCTAGTCGAGTG-1	Myeloid
AGCAGCCTCTACTATC-1	Myeloid
CCTCAGTCACTGTGTA-1	Myeloid
CTGCTGTCATATACCG-1	Myeloid
GGCTGGTAGCCACCTG-1	Myeloid
AGATTGCGTCTTGATG-1	Myeloid
ATCGAGTGTCCGCTGA-1	Myeloid
GTGTTAGCATGAACCT-1	Myeloid
CATCGAAGTTCGAATC-1	Myeloid
CACATAGGTTAGTGGG-1	Myeloid
TACGGGCCAGGCTCAC-1	Myeloid
ACGCCAGAGCTATGCT-1	Myeloid
GTCGGGTTCGGCTTGG-1	Myeloid
AGGTCCGAGAGTCTGG-1	Myeloid
ACATCAGTCAGCGATT-1	Myeloid
CGGTTAAAGCCAGAAC-1	Myeloid
AGACGTTCACGGACAA-1	Myeloid
GCGCGATGTGGACGAT-1	Myeloid
TAAGCGTCAAATTGCC-1	Myeloid
ACGATGTTCTACTATC-1	Myeloid
GTCATTTAGACTCGGA-1	Myeloid
GACTACATCTAGAGTC-1	Myeloid
CATCGGGAGCTGCGAA-1	Myeloid
TGATTTCGTCCGTCAG-1	Myeloid
TGGGCGTTCGCAGGCT-1	Myeloid
GTCTTCGAGTAGCCGA-1	Myeloid
CAGCCGAAGAAGGACA-1	Myeloid
CAGCATATCATAGCAC-1	Myeloid
ATGCGATGTATCTGCA-1	Myeloid
ACGGGTCTCAGGATCT-1	Myeloid
TGAAAGAGTCTAGTCA-1	Myeloid
CGGACACGTAAGTTCC-1	Myeloid
AAATGCCCACAGACTT-1	Myeloid
GCAAACTAGTGTTAGA-1	Myeloid
GTAGTCAAGGCATGTG-1	Myeloid
CTCATTACATAGACTC-1	Myeloid
GCATACATCATTTGGG-1	Myeloid
AGTAGTCTCCACGACG-1	Myeloid
CTACATTTCCAATGGT-1	Myeloid
TGACGGCTCTAACGGT-1	Myeloid
GGGCATCGTCTAGTCA-1	Myeloid
TTTGTCAGTTATCCGA-1	Myeloid
CATGGCGTCACTTCAT-1	Myeloid
ATAGACCGTGCCTGGT-1	Myeloid
GTCGTAAAGGGATACC-1	Myeloid
TTGACTTGTAGGACAC-1	Myeloid
TATTACCGTCTAGGTT-1	Myeloid
CTAATGGGTCCTCTTG-1	Myeloid
CTAATGGAGATATGCA-1	Myeloid
GCTGCTTAGGCTAGAC-1	Myeloid
TGATTTCGTGTGAAAT-1	Myeloid
CTCGGGATCTTGGGTA-1	Myeloid
ACGATACCATGCCACG-1	Myeloid
TTGGAACAGAAAGTGG-1	Myeloid
CCATGTCTCCAAACTG-1	Myeloid
ATCCACCAGATGTAAC-1	Myeloid
TCGCGTTAGTAGGCCA-1	Myeloid
CGTCAGGCAGCTGCAC-1	Myeloid
TACAGTGCATTAGGCT-1	Myeloid
TGAGCCGAGAGCTGCA-1	Myeloid
CCATTCGGTTTGTTGG-1	Myeloid
TCGCGTTCACGGACAA-1	Myeloid
GTAGTCACATTCTTAC-1	Myeloid
CGCTTCACAAGTAATG-1	Myeloid
AGCGGTCTCCTTAATC-1	Myeloid
TCAGCTCTCGGAAATA-1	Myeloid
GAATAAGAGATCCTGT-1	Myeloid
GAATAAGCACGTGAGA-1	Myeloid
ACACCCTCAAGTTGTC-1	Myeloid
AGACGTTCAAGAGTCG-1	Myeloid
AGTGTCAAGATCCCGC-1	Myeloid
CTAACTTAGAGTAAGG-1	Myeloid
TGAAAGAAGGGCTTGA-1	Myeloid
ACCAGTACAGGTGGAT-1	Myeloid
CACACAATCGAGGTAG-1	Myeloid
TTTATGCCAGCGTAAG-1	Myeloid
CGTCTACCACAGATTC-1	Myeloid
GTCCTCAGTGGTACAG-1	Myeloid
GTCATTTGTCACCCAG-1	Myeloid
GCTTCCAAGCTGCGAA-1	Myeloid
TACTTGTGTCCAGTGC-1	Myeloid
ACGGCCACAAGAGGCT-1	Myeloid
AAACGGGGTCGTGGCT-1	Myeloid
GGTGAAGCAAGCGTAG-1	Myeloid
GCAATCAGTACTTCTT-1	Myeloid
CGCGGTACAATGGACG-1	Myeloid
TTGGCAAGTGCTTCTC-1	Myeloid
TCGCGTTTCTTTAGGG-1	Myeloid
CGTGTAACATCCGCGA-1	Myeloid
GCAGTTATCCTTGCCA-1	Myeloid
TCTATTGGTCCCTACT-1	Myeloid
TGACTTTGTCATATGC-1	Myeloid
GTGCGGTCATGCTGGC-1	Myeloid
CCTCAGTAGCTAGTGG-1	Myeloid
ATCACGAGTATAAACG-1	Myeloid
CAGAGAGGTAAAGTCA-1	Myeloid
TTGTAGGGTCATATGC-1	Myeloid
TGCGGGTAGGTAAACT-1	Myeloid
AGGCCGTCAGCGTCCA-1	Myeloid
AACTGGTAGATATGGT-1	Myeloid
CACATTTAGACACTAA-1	Myeloid
AGGGTGACATTGCGGC-1	Myeloid
CAGCTGGTCGTTTGCC-1	Myeloid
TGTATTCTCTGAGGGA-1	Myeloid
CTCATTAAGGATGTAT-1	Myeloid
ACTGAACCACCGAAAG-1	Myeloid
TAGCCGGAGTATGACA-1	Myeloid
TCGCGAGTCGCGTTTC-1	Myeloid
GCAGTTACAGGACCCT-1	Myeloid
CGTGTAAGTTGAACTC-1	Myeloid
TGACAACCACCAGATT-1	Myeloid
CTGTTTACATAGTAAG-1	Myeloid
TCAACGACACGTCAGC-1	Myeloid
CCCTCCTTCGTAGGAG-1	Myeloid
CGTTCTGGTATCACCA-1	Myeloid
CAACTAGAGAGTACCG-1	Myeloid
GTCTTCGGTCAAAGAT-1	Myeloid
AGCCTAAAGCCGCCTA-1	Myeloid
TTAGTTCCATGTAAGA-1	Myeloid
AAGGTTCAGTCGTACT-1	Myeloid
AATCGGTCAAGGGTCA-1	Myeloid
GTAACTGAGAGTCTGG-1	Myeloid
TCGCGTTAGACTCGGA-1	Myeloid
AATCCAGGTCCGCTGA-1	Myeloid
TCTGAGAAGACATAAC-1	Myeloid
CGGAGCTTCACCTCGT-1	Myeloid
AGGTCCGTCCTACAGA-1	Myeloid
CTCTACGAGCTGAAAT-1	Myeloid
GATCGCGGTCGGATCC-1	Myeloid
GTACGTAAGCTAACAA-1	Myeloid
GCGCAGTCAAACTGCT-1	Myeloid
GCACATATCATCTGCC-1	Myeloid
CACCAGGTCGGTTAAC-1	Myeloid
CACAGTAAGGTTACCT-1	Myeloid
GACGTTACAAGGCTCC-1	Myeloid
ATCATGGCAGCCTTGG-1	Myeloid
TTCTACAAGACTGTAA-1	Myeloid
ACCGTAAAGCGAAGGG-1	Myeloid
ACATCAGAGATCGGGT-1	Myeloid
TCAACGATCTTGCCGT-1	Myeloid
GGAACTTTCTGCGGCA-1	Myeloid
GGACAAGGTCGGCATC-1	Myeloid
CGAGCCAAGGCGCTCT-1	Myeloid
GTAACTGCAAGCTGGA-1	Myeloid
TGAAAGAGTGGTACAG-1	Myeloid
GGTGAAGGTGTCGCTG-1	Myeloid
CCGTACTGTACAAGTA-1	Myeloid
AGCTCTCGTAAGGATT-1	Myeloid
TGCGTGGGTAGTAGTA-1	Myeloid
TGAGCATCACGAGAGT-1	Myeloid
CGATGGCTCTCAAGTG-1	Myeloid
GCATGTACATGGTCAT-1	Myeloid
ATCGAGTTCGACCAGC-1	Myeloid
ACTGCTCGTCGCGGTT-1	Myeloid
AGCGGTCTCTGTGCAA-1	Myeloid
CAGAATCCATCCTAGA-1	Myeloid
GCAGTTAGTAGCTCCG-1	Myeloid
TGTCCCAAGTCTCAAC-1	Myeloid
ACGATGTGTAGGGTAC-1	Myeloid
CTAACTTAGAATTCCC-1	Myeloid
TCGAGGCCAATTGCTG-1	Myeloid
CGCCAAGGTCTCCCTA-1	Myeloid
TGCTGCTGTGTCCTCT-1	Myeloid
GGTGAAGCACGGCGTT-1	Myeloid
CGTCACTTCCGTAGGC-1	Myeloid
ACACTGACAGCCTATA-1	Myeloid
AGAGCGAGTTGTCGCG-1	Myeloid
TTCTCAACAATAAGCA-1	Myeloid
TCGTAGATCCTGTAGA-1	Myeloid
ACGGCCATCAGTGCAT-1	Myeloid
ACCCACTTCGTCTGAA-1	Myeloid
CCATTCGCATTGAGCT-1	Myeloid
TCATTTGTCGTCACGG-1	Myeloid
AGGTCATTCAGAAATG-1	Myeloid
GTTAAGCAGACTAGAT-1	Myeloid
GAACGGAAGTGGGTTG-1	Myeloid
CGATGTAAGTTACGGG-1	Myeloid
GACGCGTCATGCGCAC-1	Myeloid
TACTCATTCCTTTACA-1	Myeloid
CCCATACGTAGTAGTA-1	Myeloid
TACGGGCTCTCAAGTG-1	Myeloid
TCAGCTCCACCCAGTG-1	Myeloid
CATATTCCATCACAAC-1	Myeloid
TGCTGCTCATCACCCT-1	Myeloid
TCGTACCGTGGCTCCA-1	Myeloid
TCTATTGTCTAGCACA-1	Myeloid
AGAGCGAGTCAATGTC-1	Myeloid
ACCCACTCAAGCCGTC-1	Myeloid
GTGGGTCTCGCTAGCG-1	Myeloid
CCTCTGAAGATACACA-1	Myeloid
CATTCGCTCACTCTTA-1	Myeloid
CTGCGGATCCCAAGAT-1	Myeloid
ACACCAATCTCTAGGA-1	Myeloid
TGAGAGGGTATGGTTC-1	Myeloid
CACACCTGTCAATGTC-1	Myeloid
TAAGTGCAGACAATAC-1	Myeloid
CGGACGTTCAGTTCGA-1	Myeloid
GATCGTAGTTCTGGTA-1	Myeloid
CACATTTGTCTTGTCC-1	Myeloid
CGAGCACGTCACTGGC-1	Myeloid
GATGAAAAGAGGTTAT-1	Myeloid
ACTGAACTCCAGAAGG-1	Myeloid
AACACGTTCAGCTGGC-1	Myeloid
GTAACTGAGGCAGTCA-1	Myeloid
TGTTCCGGTGACGCCT-1	Myeloid
TGGGAAGTCAAGGCTT-1	Myeloid
GAGTCCGCAACTGCGC-1	Myeloid
ACGGGTCTCATACGGT-1	Myeloid
ACGAGGAAGAAGATTC-1	Myeloid
CCCTCCTTCGGTCCGA-1	Myeloid
TCCCGATTCCAAGTAC-1	Myeloid
TGCCCTAAGCTAAGAT-1	Myeloid
GAAGCAGTCTCGGACG-1	Myeloid
CGTCCATAGACAATAC-1	Myeloid
CAAGAAATCGTTACGA-1	Myeloid
AACTGGTCACGTGAGA-1	Myeloid
GCTGCAGCAGGGATTG-1	Myeloid
ATGTGTGAGCGCTTAT-1	Myeloid
CCACGGATCTTCCTTC-1	Myeloid
ATCATGGCATTTGCTT-1	Myeloid
GTTCTCGCAAAGCGGT-1	Myeloid
AGAATAGCATCCTAGA-1	Myeloid
TTTATGCCAACGCACC-1	Myeloid
TCAGATGAGGTAGCTG-1	Myeloid
TTAGGACGTTGACGTT-1	Myeloid
TAAACCGGTCCGAATT-1	Myeloid
CACATTTCAAATCCGT-1	Myeloid
TCATTTGGTCTAAAGA-1	Myeloid
AGCTCTCCAAGCGAGT-1	Myeloid
TCAGCTCGTGGGTATG-1	Myeloid
ACGCCGAAGTACGATA-1	Myeloid
TGCGGGTTCGTCGTTC-1	Myeloid
CCGTTCATCATGTGGT-1	Myeloid
TACTTGTGTTCGAATC-1	Myeloid
CGAGAAGGTCGTGGCT-1	Myeloid
GACACGCGTCTGCCAG-1	Myeloid
TGCGCAGGTAGCACGA-1	Myeloid
ACGCCAGGTTGGTAAA-1	Myeloid
CAGCGACTCCTAGAAC-1	Myeloid
CATATTCCAGTATGCT-1	Myeloid
GCCTCTACACTTAAGC-1	Myeloid
GGACGTCTCTCTAAGG-1	Myeloid
TGCGTGGGTGTGGTTT-1	Myeloid
ATAAGAGCAGGGTTAG-1	Myeloid
CTGAAACAGAGTACCG-1	Myeloid
CCACCTATCTACCAGA-1	Myeloid
AGCGTCGCATGGTCAT-1	Myeloid
GCACTCTTCATTGCCC-1	Myeloid
CAAGATCTCTCCAGGG-1	Myeloid
CCTTACGGTCGCCATG-1	Myeloid
CGAGCCACAGCTCCGA-1	Myeloid
TGTGGTAAGAGGTAGA-1	Myeloid
TTAACTCAGAACAATC-1	Myeloid
CGCCAAGTCTGCCAGG-1	Myeloid
CACATAGGTGGCTCCA-1	Myeloid
CGACTTCGTTAAGACA-1	Myeloid
TCATTACTCGTCTGAA-1	Myeloid
AGCTCCTTCAAACAAG-1	Myeloid
GATTCAGTCTCACATT-1	Myeloid
AGAATAGGTGTTCGAT-1	Myeloid
CTTTGCGTCTCTAAGG-1	Myeloid
CCTACCAAGAGTACCG-1	Myeloid
TTGGAACGTCCGTGAC-1	Myeloid
ATAACGCCACCAGGTC-1	Myeloid
TCTATTGTCTTGCAAG-1	Myeloid
TACGGATTCAACGGCC-1	Myeloid
ATAAGAGAGGTGTTAA-1	Myeloid
AGACGTTTCGAGAGCA-1	Myeloid
ACAGCTAAGCGTCAAG-1	Myeloid
CTTTGCGGTTTGTGTG-1	Myeloid
ACGCCGATCTCCAACC-1	Myeloid
GAACCTACACCGGAAA-1	Myeloid
GGTGAAGTCAAACCGT-1	Myeloid
AAACGGGGTAAGGGAA-1	Myeloid
TTAGGACGTCTCTTTA-1	Myeloid
CATATGGGTCATTAGC-1	Myeloid
CCCAGTTCATGTTGAC-1	Myeloid
TCTGGAACATCGATGT-1	Myeloid
ACACTGATCTCGTATT-1	Myeloid
GTGAAGGAGTCTCAAC-1	Myeloid
ACATGGTCATTTCAGG-1	Myeloid
TCGCGTTAGGAGTAGA-1	Myeloid
TGTGGTAGTTCCGTCT-1	Myeloid
TGACTAGTCTTGGGTA-1	Myeloid
ATTGGTGAGGAACTGC-1	Myeloid
CATCGGGGTGTCGCTG-1	Myeloid
ACGTCAACAGTTTACG-1	Myeloid
GTGCAGCAGACTTTCG-1	Myeloid
AACTCTTAGTGGAGTC-1	Myeloid
CGCTGGACAAGACACG-1	Myeloid
CGTAGGCCAAAGAATC-1	Myeloid
GACTACAAGAGGACGG-1	Myeloid
ACAGCCGGTGTGACGA-1	Myeloid
ACTGAGTGTTCTGAAC-1	Myeloid
GATCTAGCAGCTGCAC-1	Myeloid
CCCAGTTGTTCGGGCT-1	Myeloid
GTGCGGTCAAGAGTCG-1	Myeloid
GCAATCATCACAACGT-1	Myeloid
GTGCTTCAGGTGCACA-1	Myeloid
CCTTTCTAGAATTCCC-1	Myeloid
CGTGTCTGTAGCTTGT-1	Myeloid
CCGTTCACAGGTGGAT-1	Myeloid
TAGTGGTCACCGAAAG-1	Myeloid
GTGCTTCTCTAACGGT-1	Myeloid
TGCCCATTCCATGCTC-1	Myeloid
CAGCCGAAGCCGTCGT-1	Myeloid
ACACCGGCAGCGTTCG-1	Myeloid
CAAGATCGTAGGCATG-1	Myeloid
GCAGTTACATCTATGG-1	Myeloid
CGGGTCAAGCCCAATT-1	Myeloid
TGCCCATGTTAGAACA-1	Myeloid
TCGTACCGTCGCATCG-1	Myeloid
CGGAGTCGTACTCAAC-1	Myeloid
CGTTAGAAGCGTTGCC-1	Myeloid
TAAACCGAGCAATATG-1	Myeloid
GACGCGTCACCAGTTA-1	Myeloid
CGTTCTGCAAACAACA-1	Myeloid
AGCATACCAAAGGAAG-1	Myeloid
TGGTTCCTCTTGAGAC-1	Myeloid
TGCTGCTAGCAGCCTC-1	Myeloid
TCTCTAAAGGGCTTGA-1	Myeloid
GGAAAGCGTGCAACTT-1	Myeloid
GCTGCGAAGTACGACG-1	Myeloid
TTAGTTCAGGACACCA-1	Myeloid
TTAGTTCTCCAACCAA-1	Myeloid
AGCTTGAAGTAATCCC-1	Myeloid
TCGGTAATCAGATAAG-1	Myeloid
CGTGAGCAGACAAAGG-1	Myeloid
GCGACCAGTCCATCCT-1	Myeloid
CATCGGGTCTTGCCGT-1	Myeloid
TGTTCCGTCTATGTGG-1	Myeloid
TTCTACAAGGTAGCTG-1	Myeloid
AGCTCTCCATAGACTC-1	Myeloid
TAGACCATCCAAATGC-1	Myeloid
TTCTCCTCATGTAAGA-1	Myeloid
CAGCAGCAGATATGGT-1	Myeloid
TAGGCATTCGTACGGC-1	Myeloid
TAGCCGGAGTTGCAGG-1	Myeloid
AGTGAGGGTATCTGCA-1	Myeloid
AATCGGTCAATGGTCT-1	Myeloid
CTACGTCAGTCCGGTC-1	Myeloid
ACTGAGTCATCACGAT-1	Myeloid
CATTCGCGTGAAATCA-1	Myeloid
CATGGCGGTTCAGACT-1	Myeloid
CGGACTGTCTCAAACG-1	Myeloid
CCTAAAGCAAACGTGG-1	Myeloid
GTAGGCCCAGGGCATA-1	Myeloid
AGGGATGGTAAGTTCC-1	Myeloid
CAAGATCCAATGGTCT-1	Myeloid
ACTTTCACATTTCAGG-1	Myeloid
ACTGATGCAATGTAAG-1	Myeloid
GAACCTACAATGTAAG-1	Myeloid
GAGGTGAGTGTGCCTG-1	Myeloid
TGCGGGTTCGCAAACT-1	Myeloid
CGTAGCGAGAAGCCCA-1	Myeloid
TAAGTGCAGTCACGCC-1	Myeloid
TCATTTGTCCGCAGTG-1	Myeloid
CAAGTTGAGCGATAGC-1	Myeloid
TCGAGGCAGAAACCAT-1	Myeloid
TACCTTAGTCGAAAGC-1	Myeloid
TTCTCCTCACGGACAA-1	Myeloid
TGATTTCCATTTGCCC-1	Myeloid
CACACTCCAATGGATA-1	Myeloid
CGCTGGACACTATCTT-1	Myeloid
CTGTGCTAGGACTGGT-1	Myeloid
GTACGTAGTCCAACTA-1	Myeloid
TTGCCGTGTACGACCC-1	Myeloid
TGCACCTCACCAGGTC-1	Myeloid
CAAGGCCAGGTGGGTT-1	Myeloid
CGATCGGTCAAACGGG-1	Myeloid
CATGACAAGTGGTCCC-1	Myeloid
CTAATGGGTAAATGTG-1	Myeloid
CTCGGGAAGTACGTTC-1	Myeloid
ACAGCCGAGTTTAGGA-1	Myeloid
CGGTTAAGTTAGTGGG-1	Myeloid
TACGGTACATGTTGAC-1	Myeloid
ATAAGAGCAGCTGCAC-1	Myeloid
TGTGTTTCACTGAAGG-1	Myeloid
TCATTACAGGTCATCT-1	Myeloid
CGATGTAAGGGCTTGA-1	Myeloid
CATATGGCACAGTCGC-1	Myeloid
CCTTCGAGTCTTGTCC-1	Myeloid
CATCGAAAGTTAAGTG-1	Myeloid
TTGCCGTTCACCAGGC-1	Myeloid
GCGCGATGTATCAGTC-1	Myeloid
CAAGAAATCCCTAACC-1	Myeloid
TTCCCAGCACCTGGTG-1	Myeloid
AAGGTTCGTTGATTCG-1	Myeloid
AAAGATGAGTGTTTGC-1	Myeloid
GGGATGATCCCTAATT-1	Myeloid
CTCTAATTCCAGTATG-1	Myeloid
AAGGAGCAGGAATTAC-1	Myeloid
GCACATACAGACTCGC-1	Myeloid
TGCACCTGTCGCATAT-1	Myeloid
GTGGGTCGTTCAGGCC-1	Myeloid
TAGTTGGCACGAGGTA-1	Myeloid
AGCGGTCAGATAGTCA-1	Myeloid
AGGTCCGAGGAGCGTT-1	Myeloid
TATCAGGTCACGAAGG-1	Myeloid
GAATGAAAGCCAGGAT-1	Myeloid
CCCAATCCATAGTAAG-1	Myeloid
CATCCACCAATAACGA-1	Myeloid
GAACGGAGTCATACTG-1	Myeloid
TACTCGCAGTTTGCGT-1	Myeloid
CTAGCCTTCTGATTCT-1	Myeloid
CAGCCGACAAGAGTCG-1	Myeloid
GCAATCATCTTTAGTC-1	Myeloid
GGTGTTATCTCTGCTG-1	Myeloid
ACACCGGGTCAAACTC-1	Myeloid
CGAACATGTAGAAGGA-1	Myeloid
GTCTCGTTCCAAGTAC-1	Myeloid
CAAGGCCTCGAACTGT-1	Myeloid
ATGAGGGGTAAATGTG-1	Myeloid
GCGACCACACATGACT-1	Myeloid
TACTCGCAGTGGTAGC-1	Myeloid
TCAGATGAGCTTTGGT-1	Myeloid
CAACTAGAGGATGTAT-1	Myeloid
AATCGGTTCTGACCTC-1	Myeloid
GCGGGTTAGGATCGCA-1	Myeloid
CCAGCGATCAGCAACT-1	Macrophage
GTCGGGTAGATCCCGC-1	Macrophage
TGTGGTAAGTACGTAA-1	Macrophage
ACATCAGGTGTGGCTC-1	Macrophage
GCATGTAGTCTGGAGA-1	Macrophage
ACATCAGTCTATCCTA-1	Macrophage
AACTTTCTCGGCTTGG-1	Macrophage
CGTGAGCGTCAAAGCG-1	Macrophage
TCGGGACAGCGTGTCC-1	Macrophage
AGATTGCTCGATCCCT-1	Macrophage
CGTGTAACAAGTACCT-1	Macrophage
AGAGTGGGTTCCGGCA-1	Macrophage
CTAATGGTCCGCAAGC-1	Macrophage
GGAATAACATATGAGA-1	Macrophage
CACACTCAGTCCTCCT-1	Macrophage
TCTGGAACAATAGCAA-1	Macrophage
CTGGTCTCACCGAATT-1	Macrophage
TAGTGGTAGGCATTGG-1	Macrophage
GGCTGGTTCCAGAGGA-1	Macrophage
ACACTGACAGCCAATT-1	Macrophage
TGTGTTTGTGCCTGGT-1	Macrophage
TATTACCCAATAAGCA-1	Macrophage
CAGAATCTCAACACTG-1	Macrophage
TATCAGGGTGTGAATA-1	Macrophage
GACGCGTAGATCCGAG-1	Macrophage
CGGACGTAGGAGTCTG-1	Macrophage
TTTGTCAGTATGGTTC-1	Macrophage
TAAACCGGTCGGCTCA-1	Macrophage
CTCTGGTAGGCTCTTA-1	Macrophage
CCTACACAGAACTCGG-1	Macrophage
TTCTCCTAGTCATCCA-1	Macrophage
TGGCGCATCGGGAGTA-1	Macrophage
GCGCAACAGGATGTAT-1	Macrophage
CCATGTCGTGTTGAGG-1	Macrophage
CAACCAATCACGCGGT-1	Macrophage
TACCTATGTTTGTGTG-1	Macrophage
AGGTCATTCTTGAGGT-1	Macrophage
AGTCTTTCAGCGTTCG-1	Macrophage
GCTTGAAGTTCCATGA-1	Macrophage
CGCTATCTCGTGTAGT-1	Macrophage
AGGCCACAGTCGTACT-1	Macrophage
TGACTAGCAGTGGGAT-1	Macrophage
CCTACACTCCAACCAA-1	Macrophage
CACATAGCAAAGAATC-1	Macrophage
GCGAGAATCAACCAAC-1	Macrophage
CCCAGTTCAAGGTGTG-1	Macrophage
TCGGGACTCTGCTGCT-1	Macrophage
GGCGTGTTCTCTTGAT-1	Macrophage
CGTCACTCAGACGCAA-1	Macrophage
TAAGTGCAGGCACATG-1	Macrophage
ACTTGTTAGAGTGACC-1	Macrophage
CTAACTTGTACTTAGC-1	Macrophage
AAAGCAATCACATGCA-1	Macrophage
ACTGTCCCAAGGCTCC-1	Macrophage
GATCGATAGCTAGCCC-1	Macrophage
GGACATTTCTAACGGT-1	Macrophage
AGTGTCATCGTCCGTT-1	Macrophage
ATGGGAGTCCTTGACC-1	Macrophage
TTCTACAAGTGGGATC-1	Macrophage
TCGTACCTCCATGAAC-1	Macrophage
CCTACCATCGGTTAAC-1	Macrophage
CGCGGTAGTAACGCGA-1	Macrophage
GTGAAGGGTAGGACAC-1	Macrophage
CTACCCAGTCATCGGC-1	Macrophage
CCGTGGAAGAATCTCC-1	Macrophage
GTCAAGTCACATTTCT-1	Macrophage
CGAGCCAAGTGCTGCC-1	Macrophage
CGAATGTCACCAGGCT-1	Macrophage
CATTATCCACGACGAA-1	Macrophage
AAATGCCCACTCTGTC-1	Macrophage
TGCGCAGCATTGAGCT-1	Macrophage
TCTGGAAAGCAATCTC-1	Macrophage
GCTTGAAAGCCCGAAA-1	Macrophage
TAAGTGCTCCCGACTT-1	Macrophage
TACGGTAAGCCGATTT-1	Macrophage
AGATCTGTCGTACCGG-1	Macrophage
TTCGAAGTCTTGGGTA-1	Macrophage
AACTTTCTCAAGATCC-1	Macrophage
GGTATTGCATGCTGGC-1	Macrophage
CTAGAGTGTGTGACGA-1	Macrophage
ACTGTCCCAGCTGTTA-1	Macrophage
AGGGATGAGAGGTTGC-1	Macrophage
CGTCAGGTCTGTCCGT-1	Macrophage
CTACCCATCAATCTCT-1	Macrophage
CACATAGAGAAACGCC-1	Macrophage
CTAACTTCATTACGAC-1	Macrophage
GACACGCTCGGTCTAA-1	Macrophage
GACGCGTTCTGCGTAA-1	Macrophage
GAGTCCGGTTGCGTTA-1	Macrophage
CTACACCGTTAAAGAC-1	Macrophage
CGAGAAGAGACTTTCG-1	Macrophage
TCTATTGCAGTTCCCT-1	Macrophage
CACACCTTCGCAAGCC-1	Macrophage
ATGAGGGTCATCGCTC-1	Macrophage
GTCTCGTAGGGCATGT-1	Macrophage
CGACCTTGTTATTCTC-1	Macrophage
GGTATTGAGAAAGTGG-1	Macrophage
ATGCGATTCAAGATCC-1	Macrophage
CTCTAATGTAGGGACT-1	Macrophage
CAGGTGCTCTTCGAGA-1	Macrophage
CGGTTAAGTCTCATCC-1	Macrophage
GTCATTTCAGTCAGCC-1	Macrophage
TTTGTCACACAGACTT-1	Macrophage
AACCATGGTCATGCAT-1	Macrophage
GGGCACTGTCGAACAG-1	Macrophage
TGAGCCGTCCACGTGG-1	Macrophage
GACGTGCTCGTCGTTC-1	Macrophage
GTCGGGTCACATAACC-1	Macrophage
ATTACTCGTATCACCA-1	Macrophage
GTCGTAAAGATGCCAG-1	Macrophage
ACAGCCGTCGGTGTTA-1	Macrophage
CAGCAGCAGCCCTAAT-1	Macrophage
ATAGACCCATTTCAGG-1	Macrophage
CAGAGAGTCAAACCAC-1	Macrophage
TCTGAGAAGCGGCTTC-1	Macrophage
GAGCAGACACCAACCG-1	Macrophage
TCTTTCCTCTCATTCA-1	Macrophage
GGCTCGAAGAAAGTGG-1	Macrophage
TACGGATGTGGTACAG-1	Macrophage
TCAGGATAGAGTGACC-1	Macrophage
TGGGCGTCAGGACGTA-1	Macrophage
AACGTTGCACACCGCA-1	Macrophage
AGCTTGAAGCAATCTC-1	Macrophage
CGACTTCTCCGGCACA-1	Macrophage
CAGATCATCTTCATGT-1	Macrophage
GACACGCTCCGCTGTT-1	Macrophage
GAATAAGCAAGAGTCG-1	Macrophage
GTGGGTCAGGCAGGTT-1	Macrophage
CACATAGGTGGACGAT-1	Macrophage
ACCAGTATCTAGAGTC-1	Macrophage
CGACCTTGTGGTGTAG-1	Macrophage
TTCTCAAAGAATTCCC-1	Macrophage
GACGTTAGTCCATCCT-1	Macrophage
GACAGAGAGTCAAGCG-1	Macrophage
CAGCTGGCAACCGCCA-1	Macrophage
CAACCAAAGGGCATGT-1	Macrophage
CTAATGGTCTGGCGTG-1	Macrophage
ATTTCTGGTAAATACG-1	Macrophage
CGTCTACCAGACAGGT-1	Macrophage
CTGTGCTCAATCAGAA-1	Macrophage
CATCAGACAAGCGATG-1	Macrophage
GCGACCAGTCCAACTA-1	Macrophage
AGCGTATAGCCAGGAT-1	Macrophage
TGCCCATTCGGTGTCG-1	Macrophage
ACGCAGCGTCGAGTTT-1	Macrophage
CGACCTTGTGTAAGTA-1	Macrophage
CGACCTTCAAGCCTAT-1	Macrophage
GTCAAGTAGTTGTCGT-1	Macrophage
CTACGTCGTTATGCGT-1	Macrophage
TGAAAGACATTGCGGC-1	Macrophage
TGAAAGAGTCCGAAGA-1	Macrophage
CACCTTGCAGGAACGT-1	Macrophage
AAAGATGCAGTCGATT-1	Macrophage
CACATTTTCTTGGGTA-1	Macrophage
GACTACATCAGAAATG-1	Macrophage
GATGAGGTCCTTAATC-1	Macrophage
CACACTCCATCGGAAG-1	Macrophage
ACGGGTCGTTACGCGC-1	Macrophage
ATTATCCAGATGCGAC-1	Macrophage
GTACTCCTCGGAATCT-1	Macrophage
TCGCGAGCAATGGAGC-1	Macrophage
TAGTTGGTCGCGGATC-1	Macrophage
GGCTCGACAAGTCTGT-1	Macrophage
GAAGCAGAGATATACG-1	Macrophage
TTGTAGGTCATCGCTC-1	Macrophage
TCTGAGACAGACACTT-1	Macrophage
GACCTGGTCCGCGGTA-1	Macrophage
CTCTGGTAGAATGTGT-1	Macrophage
CGGACGTCAACACGCC-1	Macrophage
CGGTTAAAGCCGTCGT-1	Macrophage
TACCTTAGTCTGGTCG-1	Macrophage
ACTGCTCGTCAGCTAT-1	Macrophage
CGCTATCGTTGCGTTA-1	Macrophage
ATTACTCAGAACTGTA-1	Macrophage
TACCTTAAGCGTAATA-1	Macrophage
ACTGAACGTTGGTGGA-1	Macrophage
GCTGCGAAGATGCGAC-1	Macrophage
GGCCGATAGTCACGCC-1	Macrophage
CGTGAGCTCGTCCAGG-1	Macrophage
TGAGCATGTAGCTTGT-1	Macrophage
AAATGCCGTGCCTGTG-1	Macrophage
CAGCCGATCAGAGACG-1	Macrophage
GTAACTGAGTTAGGTA-1	Macrophage
TCTGGAATCTTAACCT-1	Macrophage
GGACATTGTCTCCCTA-1	Macrophage
CTAATGGTCAGAGACG-1	Macrophage
TTTATGCTCTTGTACT-1	Macrophage
AAGGTTCTCGGAAACG-1	Macrophage
GCATACAGTGTAATGA-1	Macrophage
GACTGCGCATTGGTAC-1	Macrophage
CCTTCGAAGCCGTCGT-1	Macrophage
CCACGGAAGAAGATTC-1	Macrophage
TCAGGTAGTCCTCCAT-1	Macrophage
TAGTTGGGTGTGCCTG-1	Macrophage
TTGCGTCAGTCCAGGA-1	Macrophage
TAAGTGCAGATAGGAG-1	Macrophage
GTCATTTTCCGTCAAA-1	Macrophage
GGCTCGAGTAAGTGTA-1	Macrophage
TGATTTCAGATGGCGT-1	Macrophage
CAACCTCTCATAACCG-1	Macrophage
ACCGTAATCCCTGACT-1	Macrophage
TCTTCGGCACGTTGGC-1	Macrophage
TAGACCAGTGAGGGAG-1	Macrophage
GTATCTTCAGCTATTG-1	Macrophage
TACTTGTCATCTCCCA-1	Macrophage
CTGCTGTGTAGGGACT-1	Macrophage
GCGCCAAGTGATGATA-1	Macrophage
GCTGGGTAGTGACTCT-1	Macrophage
CTCGAGGTCTAACTTC-1	Macrophage
TCGAGGCAGGCTCAGA-1	Macrophage
AACCGCGAGTAGCCGA-1	Macrophage
TCGGTAATCCTCAACC-1	Macrophage
GAAGCAGAGTCGTTTG-1	Macrophage
TCAATCTGTGGAAAGA-1	Macrophage
TCACAAGTCGAACGGA-1	Macrophage
GCGAGAAGTGCAACGA-1	Macrophage
CGAATGTCACAGACTT-1	Macrophage
AGCATACCACAGCGTC-1	Macrophage
CTTAACTCAGCCTATA-1	Macrophage
TAGTGGTAGTACGACG-1	Macrophage
GCTGCAGGTCCGTCAG-1	Macrophage
TGAGCATCATGTAAGA-1	Macrophage
ACGCCAGCAAGTCTAC-1	Macrophage
TATTACCTCAAACCGT-1	Macrophage
CCGTACTTCGTGGGAA-1	Macrophage
CTCAGAACAAATTGCC-1	Macrophage
TAGAGCTAGCGAGAAA-1	Macrophage
GTCATTTAGCCACGTC-1	Macrophage
CACCAGGGTTGCTCCT-1	Macrophage
TGAGCATCAAGTCTGT-1	Macrophage
GACGTGCCATTCCTGC-1	Macrophage
CAGCCGATCTCTAGGA-1	Macrophage
GCCTCTATCCGGCACA-1	Macrophage
CTGCCTAAGAAGATTC-1	Macrophage
TGAGCCGAGGTACTCT-1	Macrophage
CCTATTAGTACGACCC-1	Macrophage
AACGTTGCAGCCTTTC-1	Macrophage
GAGTCCGCATAGAAAC-1	Macrophage
ACATGGTAGCTTCGCG-1	Macrophage
CTGAAACCACATTAGC-1	Macrophage
ATCCGAATCCAGTATG-1	Macrophage
TACTTGTAGAGGTTGC-1	Macrophage
GCTTGAATCTGTCAAG-1	Macrophage
GTAGTCACAATAACGA-1	Macrophage
GGACAGACATGCTGGC-1	Macrophage
CGCCAAGCACCATCCT-1	Macrophage
CATTATCGTTCGTGAT-1	Macrophage
AAATGCCTCAGGATCT-1	Macrophage
TGCCAAACATTAACCG-1	Macrophage
TCTCTAAAGCGTCAAG-1	Macrophage
ACCCACTGTGTAATGA-1	Macrophage
GGTGCGTCATCGATGT-1	Macrophage
TCCCGATGTAGAGCTG-1	Macrophage
CTACCCACACCCATTC-1	Macrophage
CTCATTACAGTCCTTC-1	Macrophage
CTAGAGTGTTCACCTC-1	Macrophage
CAGCTAAAGATCCGAG-1	Macrophage
CAGCTAAAGCGATAGC-1	Macrophage
GGCCGATCATGGTCAT-1	Macrophage
CACACCTGTCTCTTAT-1	Macrophage
AAGACCTGTCTCTTTA-1	Macrophage
TTCCCAGGTCTTCAAG-1	Macrophage
CTGCGGATCTCCGGTT-1	Macrophage
ACCGTAAGTTTGTGTG-1	Macrophage
GTCGGGTTCGTGACAT-1	Macrophage
TGACTTTGTGGTGTAG-1	Macrophage
CTCCTAGGTAGCTGCC-1	Macrophage
TCGCGTTAGTGAACAT-1	Macrophage
AGGGATGAGATGGGTC-1	Macrophage
ATTACTCTCATCACCC-1	Macrophage
CCGGTAGAGAATCTCC-1	Macrophage
GGGATGATCAGCTCTC-1	Macrophage
TATGCCCGTCCAGTGC-1	Macrophage
ATAAGAGTCAGGTTCA-1	Macrophage
ACGCCAGCACGGCCAT-1	Macrophage
TCAGGATCATCCAACA-1	Macrophage
AGGTCCGAGTCCAGGA-1	Macrophage
GATGAGGGTATCAGTC-1	Macrophage
AACTTTCCAGGGATTG-1	Macrophage
CCTTACGTCTTTAGTC-1	Macrophage
GAAACTCTCGGCTTGG-1	Macrophage
TCTTCGGTCACGCATA-1	Macrophage
AGAGCGAAGGCACATG-1	Macrophage
GTTCGGGTCAACCAAC-1	Macrophage
AGGTCATCACAAGACG-1	Macrophage
GTATTCTCAGCTGTGC-1	Macrophage
GACGCGTCAAGCCGCT-1	Macrophage
AGTTGGTTCACTTATC-1	Macrophage
GACGTTAGTCCTCTTG-1	Macrophage
GTGAAGGAGATCCCGC-1	Macrophage
ACTGAACGTCGTTGTA-1	Macrophage
GTGGGTCCATTCTTAC-1	Macrophage
AAAGTAGGTATATCCG-1	Macrophage
TCGAGGCCATTCTTAC-1	Macrophage
TGACTAGCATGTTGAC-1	Macrophage
CATTATCGTACCTACA-1	Macrophage
TCTTTCCTCTGTTTGT-1	Macrophage
ACAGCTAGTCGGCACT-1	Macrophage
CTAGAGTAGGATGGTC-1	Macrophage
TCACGAAAGGAATTAC-1	Macrophage
AGAGCGACATGCCCGA-1	Macrophage
ACCTTTAAGTCTCGGC-1	Macrophage
TTGCGTCAGGAGCGAG-1	Macrophage
CTTGGCTAGGATGCGT-1	Macrophage
CTGAAACAGCCAACAG-1	Macrophage
CAAGAAAGTTCTGTTT-1	Macrophage
CACACAAAGTGTTGAA-1	Macrophage
CCTACCAAGAAACCAT-1	Macrophage
TCCCGATGTAAGTGGC-1	Macrophage
TACTTGTAGGCTCATT-1	Macrophage
AGATCTGAGGTAGCTG-1	Macrophage
CCTTCGAGTCATGCCG-1	Macrophage
AGGTCCGCACGGTAGA-1	Macrophage
CCTTCCCCACGCGAAA-1	Macrophage
CTCGAAAGTCACAAGG-1	Macrophage
CCTCAGTCATCTATGG-1	Macrophage
TTGGCAAAGTGAACAT-1	Macrophage
CTCTAATCACCAGGCT-1	Macrophage
GCGCCAAGTCGTCTTC-1	Macrophage
GAACGGAGTCTGCGGT-1	Macrophage
CCTCTGAAGGTCGGAT-1	Macrophage
TCGTACCAGTGCCAGA-1	Macrophage
CATGACAGTCCATCCT-1	Macrophage
TGACGGCAGCGTTGCC-1	Macrophage
TATGCCCAGCCCAATT-1	Macrophage
CCTTCGACACGGTAAG-1	Macrophage
AAACGGGCAAGCCGTC-1	Macrophage
GGACGTCAGCTAGTGG-1	Macrophage
CTCACACAGACAGACC-1	Macrophage
CGTGTCTAGTTAAGTG-1	Macrophage
GACTAACCACATGTGT-1	Macrophage
ACTGAGTAGGAATTAC-1	Macrophage
CGCCAAGGTCTTGATG-1	Macrophage
CATATTCAGACTGGGT-1	Macrophage
ACACCCTCAACTTGAC-1	Macrophage
ACTGATGAGTAGGCCA-1	Macrophage
GTATCTTCATTGGTAC-1	Macrophage
GGGACCTTCACATACG-1	Macrophage
CTCGAAATCAGAAATG-1	Macrophage
ACGATGTTCTTGACGA-1	Macrophage
CGTAGCGGTAAGCACG-1	Macrophage
GGCGACTGTTACAGAA-1	Macrophage
CGGCTAGTCAGTCCCT-1	Macrophage
GATGAGGAGTTTCCTT-1	Macrophage
ATTATCCTCTGCAAGT-1	Macrophage
TCCACACAGAAGATTC-1	Macrophage
CATCCACGTTAGTGGG-1	Macrophage
CCGGGATCACCAGCAC-1	Macrophage
AGCTTGAAGAGTAATC-1	Macrophage
CGTGAGCGTAGCTTGT-1	Macrophage
TTGGAACTCTCTGAGA-1	Macrophage
CTCGTCAAGTAAGTAC-1	Macrophage
AAGTCTGGTGCCTTGG-1	Macrophage
TTGGCAATCTTAGAGC-1	Macrophage
CACAGGCTCCACGAAT-1	Macrophage
ACGAGCCAGAACAACT-1	Macrophage
CAGAGAGTCAGCGACC-1	Macrophage
CGCCAAGAGACTTGAA-1	Macrophage
GTACTCCAGGTAGCCA-1	Macrophage
AGTGGGATCGTTACAG-1	Macrophage
TACGGGCCAGTAAGCG-1	Macrophage
AGATCTGCAGTTAACC-1	Macrophage
GTGAAGGAGTTGTAGA-1	Macrophage
TTCTCCTAGTTAGCGG-1	Macrophage
CTCGGGAAGCCTATGT-1	Macrophage
ATCACGAAGATGGCGT-1	Macrophage
CACAGTATCACATACG-1	Macrophage
TGCTACCTCGCGCCAA-1	Macrophage
ATGCGATTCAGTTGAC-1	Macrophage
AGTGTCATCTGGTGTA-1	Macrophage
AGCGGTCAGTTATCGC-1	Macrophage
TTCGGTCCATCATCCC-1	Macrophage
AAGTCTGAGCGGATCA-1	Macrophage
TTCGAAGAGCTCCCAG-1	Macrophage
ACGGGTCGTGTGGTTT-1	Macrophage
AGCTTGAAGATCCCGC-1	Macrophage
GCTCTGTCAGGACCCT-1	Macrophage
TTAGGACTCCTTGCCA-1	Macrophage
TTTGGTTTCTAACTCT-1	Macrophage
GTGCAGCGTAAGTGTA-1	Macrophage
AACACGTCACTTCTGC-1	Macrophage
GTCATTTCACATCTTT-1	Macrophage
CGCTTCAAGAACTGTA-1	Macrophage
AACCGCGAGGAGTACC-1	Macrophage
GGGCATCGTACTTGAC-1	Macrophage
CCTTCGACACAACGTT-1	Macrophage
CGATCGGTCGGCTTGG-1	Macrophage
TCGGGACGTCTCGTTC-1	Macrophage
GGGTCTGAGGAGTTGC-1	Macrophage
GATTCAGTCTGCCAGG-1	Macrophage
ATTGGTGTCTTGTATC-1	Macrophage
AGCTCTCCAAGTCATC-1	Macrophage
GGGAATGCAATAACGA-1	Macrophage
TTCTTAGCACTTGGAT-1	Macrophage
TTGGCAACAGGACCCT-1	Macrophage
TGCCCTAAGCGCTCCA-1	Macrophage
CAGCATATCGTCTGCT-1	Macrophage
ACATACGAGTGGGATC-1	Macrophage
GAGGTGATCGTCGTTC-1	Macrophage
GAACGGACACTTAAGC-1	Macrophage
TAAGAGAGTTACGTCA-1	Macrophage
CACACCTAGCAATATG-1	Macrophage
CTCGGAGGTTGTTTGG-1	Macrophage
TTAACTCGTAAGGGCT-1	Macrophage
CCGGTAGTCGAACGGA-1	Macrophage
CTGAAACCATAAAGGT-1	Macrophage
CGTCACTTCGAACGGA-1	Macrophage
CGGAGCTCAACGATGG-1	Macrophage
TCAACGAAGAAGGCCT-1	Macrophage
GAGTCCGGTCTTGATG-1	Macrophage
ACGATACGTGGTTTCA-1	Macrophage
GGGTTGCTCGCCTGTT-1	Macrophage
ACCAGTACATTCCTGC-1	Macrophage
GACGTTAAGCTGAAAT-1	Macrophage
TGGGCGTCAGGCAGTA-1	Macrophage
CACATTTGTACATCCA-1	Macrophage
ACATACGTCTTGAGAC-1	Macrophage
TTCCCAGCAGCGTAAG-1	Macrophage
ATGTGTGGTCTTGCGG-1	Macrophage
TTAGGACTCAAACCGT-1	Macrophage
CTGTGCTCACGGTAGA-1	Macrophage
CGAGCCATCGATGAGG-1	Macrophage
CCTTTCTGTTTAGCTG-1	Macrophage
GTATTCTCAGTAAGCG-1	Macrophage
TCATTACGTATCAGTC-1	Macrophage
GGACATTTCAGAGACG-1	Macrophage
CCTAGCTAGCTGATAA-1	Macrophage
CTTAGGACAGCGTCCA-1	Macrophage
TCCACACAGGGTTCCC-1	Macrophage
GATCGATGTCGGATCC-1	Macrophage
CGGTTAAGTGCCTTGG-1	Macrophage
TAGGCATGTTTGACTG-1	Macrophage
ATTGGACAGACAGAGA-1	Macrophage
GCTGCAGCACAGGTTT-1	Macrophage
TTCTTAGGTCCGAATT-1	Macrophage
TTTGTCACAACACCCG-1	Macrophage
CAGCTAACACTACAGT-1	Macrophage
ACGAGGAAGCTAAACA-1	Macrophage
GTCTTCGGTTATGCGT-1	Macrophage
CCAATCCTCGCATGGC-1	Macrophage
TACTCGCGTCTAGCGC-1	Macrophage
ACGAGGATCTGTTTGT-1	Macrophage
TTTGGTTAGAGATGAG-1	Macrophage
CTAATGGCACATAACC-1	Macrophage
CGAATGTGTTTACTCT-1	Macrophage
TGAGAGGTCGTTACGA-1	Macrophage
CAAGTTGGTTCGTTGA-1	Macrophage
AAAGTAGCATCGATGT-1	Macrophage
TCGTAGAAGACTAGAT-1	Macrophage
TGCGTGGTCTCTTATG-1	Macrophage
GGGTTGCAGATCACGG-1	Macrophage
CCAGCGAGTTCTGAAC-1	Macrophage
CTCTAATAGAAGGCCT-1	Macrophage
CAGCTGGCAAATTGCC-1	Macrophage
AGGGAGTTCCATGAGT-1	Macrophage
GTCAAGTAGTCTCAAC-1	Macrophage
GTAACGTGTAAAGTCA-1	Macrophage
CCTATTACAAGGACTG-1	Macrophage
GGGTTGCCATGCATGT-1	Macrophage
CTTACCGGTCGAGTTT-1	Macrophage
TAAACCGTCATGTGGT-1	Macrophage
CTTTGCGCAACGATGG-1	Macrophage
CTCAGAAAGAAAGTGG-1	Macrophage
CAGCTGGAGACTGTAA-1	Macrophage
AGCATACCAGCATACT-1	Macrophage
AGGGTGATCCTATTCA-1	Macrophage
GTTTCTAAGTGTACCT-1	Macrophage
GGCAATTGTGATAAGT-1	Macrophage
GACTACAAGCCATCGC-1	Macrophage
CTTACCGGTTGAGGTG-1	Macrophage
CCGGGATAGAGCTATA-1	Macrophage
TTCCCAGTCTGAGGGA-1	Macrophage
CGGACGTCATGAACCT-1	Macrophage
CACACTCAGAGACTAT-1	Macrophage
TTTGGTTCAAACCTAC-1	Macrophage
CAGCTAATCTGCTGCT-1	Macrophage
TGGGAAGTCCCGGATG-1	Macrophage
ACTGATGCATCGGACC-1	Macrophage
GTTCGGGTCGAGAGCA-1	Macrophage
GATCGATCATACGCCG-1	Macrophage
TAAACCGGTCCCTACT-1	Macrophage
TGGCCAGCAATCACAC-1	Macrophage
CTAAGACGTTCAGCGC-1	Macrophage
GTACTCCTCGACAGCC-1	Macrophage
TGTCCCAGTCGCGGTT-1	Macrophage
CAAGGCCTCTCGGACG-1	Macrophage
CGTCAGGTCTACTCAT-1	Macrophage
TGAGCATTCTTAGAGC-1	Macrophage
GCACTCTGTCAGAATA-1	Macrophage
TTGAACGCAATGGTCT-1	Macrophage
GGCTCGATCCAAAGTC-1	Macrophage
ACTGTCCGTAAGGGCT-1	Macrophage
CCTAAAGCAGCTCCGA-1	Macrophage
TCGTACCGTATGAATG-1	Macrophage
TTCTTAGCAAGCCCAC-1	Macrophage
CTGTGCTTCAGCTTAG-1	Macrophage
TTCCCAGCAATAACGA-1	Macrophage
GCTGCTTAGATAGGAG-1	Macrophage
CGCGTTTGTGCGAAAC-1	Macrophage
ACACCGGCAATGAATG-1	Macrophage
TCAGCAATCGCCAGCA-1	Macrophage
AGCCTAATCGGAGGTA-1	Macrophage
GTAGTCATCGAATGCT-1	Macrophage
GGTGTTACAAAGGAAG-1	Macrophage
TTGACTTAGCTCCTCT-1	Macrophage
CTGAAGTGTTGTTTGG-1	Macrophage
ACACCGGAGAAGATTC-1	Macrophage
TAGTGGTGTCACTGGC-1	Macrophage
ACCAGTAGTGACTACT-1	Macrophage
CTCACACAGTACGCCC-1	Macrophage
ATAGACCAGTGAACAT-1	Macrophage
ACACTGACAATGGATA-1	Macrophage
TCAACGATCACTTCAT-1	Macrophage
AGTCTTTGTATGAAAC-1	Macrophage
CTAACTTGTCAGGACA-1	Macrophage
CGAGCACAGATAGCAT-1	Macrophage
TTTGGTTAGGGTTTCT-1	Macrophage
ATTGGACCAGTAGAGC-1	Macrophage
TCAATCTTCGAGAGCA-1	Macrophage
ATTATCCTCTAGCACA-1	Macrophage
TCACGAAGTCTAGCCG-1	Macrophage
GACACGCCATCCGCGA-1	Macrophage
TGACTTTAGAGTAAGG-1	Macrophage
GCGCAACAGGGTTTCT-1	Macrophage
AATCCAGAGGTGATAT-1	Macrophage
TCATTTGCACATGGGA-1	Macrophage
CACTCCATCGTCTGAA-1	Macrophage
CACAGTAAGCTAAACA-1	Macrophage
CGCTATCAGATGCCTT-1	Macrophage
CAAGAAATCTCCCTGA-1	Macrophage
CTCGGAGGTATGAATG-1	Macrophage
ACGGGTCAGACTAGGC-1	Macrophage
CGTAGGCAGATGAGAG-1	Macrophage
CTGCTGTGTCCGAAGA-1	Macrophage
ATCCACCTCGCGTTTC-1	Macrophage
CTTGGCTTCTCGAGTA-1	Macrophage
CTCATTAGTGCTGTAT-1	Macrophage
AAGGTTCCATCGTCGG-1	Macrophage
CTGTGCTAGCCACTAT-1	Macrophage
ACATCAGGTGGCAAAC-1	Macrophage
TGAAAGAGTTACCGAT-1	Macrophage
CAGAGAGTCTATCCTA-1	Macrophage
CGGTTAATCAGTTCGA-1	Macrophage
TTTATGCGTTAGATGA-1	Macrophage
CATCGGGAGACGCAAC-1	Macrophage
AGCGTATGTCGAACAG-1	Macrophage
CACCACTGTCGCCATG-1	Macrophage
AACTCAGGTATTAGCC-1	Macrophage
CTCGGAGTCCACTCCA-1	Macrophage
TACAGTGTCGTTACGA-1	Macrophage
CACACTCTCTTGAGAC-1	Macrophage
CATCGAATCCGTTGTC-1	Macrophage
ACGCCGATCAACACCA-1	Macrophage
AGCATACAGATATGGT-1	Macrophage
TCCCGATTCGTCCAGG-1	Macrophage
TATCTCAGTAATTGGA-1	Macrophage
AGAGCGACACTCAGGC-1	Macrophage
CTCACACAGCCAGTTT-1	Macrophage
AGAGCTTTCACTGGGC-1	Macrophage
GGACGTCAGTACGTTC-1	Macrophage
GTCACAATCTGTCCGT-1	Macrophage
AGACGTTAGTGACATA-1	Macrophage
TCATTACCACCCAGTG-1	Macrophage
GGACAAGCAATAAGCA-1	Macrophage
AAGGTTCTCTACGAGT-1	Macrophage
GATGAGGCATGAGCGA-1	Macrophage
TCAGGTATCTGCAAGT-1	Macrophage
AACTTTCCATCATCCC-1	Macrophage
ATCCGAAGTAGCTCCG-1	Macrophage
ACTTTCAGTCTCTTTA-1	Macrophage
TGGCGCAAGTTAACGA-1	Macrophage
GGTGAAGGTCCTCTTG-1	Macrophage
TTAACTCTCGGCGCTA-1	Macrophage
CAGCCGAGTGTTTGTG-1	Macrophage
CCACGGATCCAGTAGT-1	Macrophage
CCTATTAAGCGATCCC-1	Macrophage
CGCTGGACAGATCTGT-1	Macrophage
TTAGGCATCATCACCC-1	Macrophage
GATCGATGTTTACTCT-1	Macrophage
CCTCAGTTCGGTTAAC-1	Macrophage
CTGATAGTCTGCCCTA-1	Macrophage
CATCAAGGTACCCAAT-1	Macrophage
CGAGAAGGTGTCAATC-1	Macrophage
ACCTTTAGTCTGATTG-1	Macrophage
CGATGGCTCAGCAACT-1	Macrophage
TCAGGTAGTTCAACCA-1	Macrophage
CCCAATCCATCACGTA-1	Macrophage
CATGGCGGTACAGACG-1	Macrophage
GACAGAGAGTTACGGG-1	Macrophage
GCTCTGTAGGCTCAGA-1	Macrophage
GGCTGGTAGCTTCGCG-1	Macrophage
ACTGTCCCAGGTTTCA-1	Macrophage
CAGCATAAGCTACCGC-1	Macrophage
GCGCCAATCGTGTAGT-1	Macrophage
AAAGATGAGGCAATTA-1	Macrophage
CGTAGGCCATTTGCCC-1	Macrophage
TCAGGATAGATCGATA-1	Macrophage
TAGGCATTCCCAAGAT-1	Macrophage
TGTCCCACAAGACGTG-1	Macrophage
CGAACATCATGAACCT-1	Macrophage
AGGTCATCAGACAAGC-1	Macrophage
TCAGGTATCATAGCAC-1	Macrophage
GATCGATAGAATGTGT-1	Macrophage
ACGCCGAGTCTCTCTG-1	Macrophage
TTGCGTCTCAATAAGG-1	Macrophage
GTGTGCGGTCGGCACT-1	Macrophage
ACGAGGAGTGCACGAA-1	Macrophage
CCGTGGAAGTGAATTG-1	Macrophage
TTCTACAGTGGTAACG-1	Dendritic Cell
CTGCCTAAGGAATTAC-1	Dendritic Cell
AGCGTCGGTCGAGATG-1	Dendritic Cell
GACGTTATCCTTGGTC-1	Dendritic Cell
TCACGAATCCTCTAGC-1	Dendritic Cell
ACTATCTCAGCGTCCA-1	Dendritic Cell
GAACATCAGATAGTCA-1	Dendritic Cell
TAGAGCTTCTGTTGAG-1	Dendritic Cell
TTTGTCAAGACCACGA-1	Dendritic Cell
CTCAGAACAAAGCAAT-1	Dendritic Cell
GACACGCAGGGCATGT-1	Dendritic Cell
CTGCGGAAGACGCTTT-1	Dendritic Cell
TGAGAGGAGGCATGGT-1	Dendritic Cell
CCTTTCTAGCACACAG-1	Dendritic Cell
AGAATAGTCACTTATC-1	Dendritic Cell
GGCAATTAGGGCACTA-1	Dendritic Cell
GGCGACTTCGCCAAAT-1	Dendritic Cell
GCGCAGTCACGGCGTT-1	Dendritic Cell
CTTACCGCATGGTAGG-1	Dendritic Cell
GGGTCTGAGAATAGGG-1	Dendritic Cell
TGGGAAGCAGGTCTCG-1	Dendritic Cell
AGTCTTTCAGGTGGAT-1	Dendritic Cell
AGAGTGGAGGATCGCA-1	Dendritic Cell
TGGTTAGGTCTAAAGA-1	Dendritic Cell
TGTGTTTGTTACTGAC-1	Dendritic Cell
CTCAGAATCGCCTGAG-1	Dendritic Cell
TCACGAAAGATCCTGT-1	Dendritic Cell
CTCGAAATCGACAGCC-1	Dendritic Cell
CTCGGAGTCGGCTTGG-1	Dendritic Cell
TTCTCCTAGAGCTTCT-1	Dendritic Cell
TGGCGCACAGCCTTTC-1	Dendritic Cell
TTGACTTTCTGCAGTA-1	Dendritic Cell
GGACAGAGTAGCCTAT-1	Dendritic Cell
GAGTCCGCAATGGATA-1	Dendritic Cell
TACTTGTCATCGGAAG-1	Dendritic Cell
AGCGTCGCATGTCTCC-1	Dendritic Cell
GTCACGGTCGCGTAGC-1	Dendritic Cell
TACGGGCCATCAGTCA-1	Dendritic Cell
AGGCCGTGTGCTTCTC-1	Dendritic Cell
AAGACCTGTAGCTGCC-1	Dendritic Cell
CTAAGACGTCCATCCT-1	Dendritic Cell
ACAGCTATCGACGGAA-1	Dendritic Cell
GTCAAGTCAAACTGCT-1	Dendritic Cell
CTTCTCTGTTAGAACA-1	Dendritic Cell
CTTGGCTCACTCAGGC-1	Dendritic Cell
CCTCAGTCAGGCGATA-1	Dendritic Cell
GAATGAAGTCGCGTGT-1	Dendritic Cell
GAAATGAGTACTTAGC-1	Dendritic Cell
CCTTACGGTACTTCTT-1	Dendritic Cell
TGTATTCTCCGTAGTA-1	Dendritic Cell
TGGCGCATCTTAACCT-1	Dendritic Cell
ACTGTCCCAACTGGCC-1	Dendritic Cell
CTCGTACTCCGATATG-1	Dendritic Cell
ACATACGAGTGCCAGA-1	Dendritic Cell
CAGATCACATCTACGA-1	Dendritic Cell
GGATGTTAGGTGCTTT-1	Dendritic Cell
ATTCTACGTGGGTCAA-1	Dendritic Cell
TTTATGCCACAGGAGT-1	Dendritic Cell
GAACCTACACGCATCG-1	Dendritic Cell
CCTACACCAGATAATG-1	Dendritic Cell
AGGCCGTCAGTAGAGC-1	Dendritic Cell
AGCAGCCCACGTCTCT-1	Dendritic Cell
TACGGATAGGTAAACT-1	Dendritic Cell
TGGTTAGAGTACACCT-1	Dendritic Cell
CAAGATCAGTTCGCGC-1	Dendritic Cell
CTTCTCTGTTCTCATT-1	Dendritic Cell
GCTGCAGCAATAGCGG-1	Dendritic Cell
TAAACCGTCCGCGGTA-1	Dendritic Cell
GTTTCTAAGTGAATTG-1	NK cells
CTCGGAGTCTAACGGT-1	NK cells
GACGCGTTCATCTGTT-1	NK cells
TGTCCCAAGGCCCTTG-1	NK cells
GACCTGGAGTAGATGT-1	NK cells
CTAGAGTCAGCGAACA-1	NK cells
GCCAAATTCAAGGTAA-1	NK cells
CGAATGTTCCGCGTTT-1	NK cells
CACTCCACAGACGTAG-1	NK cells
ACTGCTCCACGGTTTA-1	NK cells
GTGCTTCTCAAGCCTA-1	NK cells
CCCTCCTTCTGGTTCC-1	NK cells
GGACAAGAGCTAGGCA-1	NK cells
AATCGGTGTCTGGTCG-1	NK cells
GTTCGGGAGAATGTGT-1	NK cells
CGTGAGCCACACTGCG-1	NK cells
TGAAAGAAGGTGACCA-1	NK cells
ACGAGCCGTTCGGGCT-1	NK cells
GACTAACGTTATGCGT-1	NK cells
AGCTCTCTCTGCCAGG-1	NK cells
ACTGTCCCACTCTGTC-1	NK cells
GCTCCTAGTTACGCGC-1	NK cells
GCGACCAGTAGAGGAA-1	NK cells
TACAGTGTCAGTTAGC-1	NK cells
ACGGGTCTCCAACCAA-1	NK cells
CTGATCCGTAGAAGGA-1	NK cells
AGAGCGACAAACCTAC-1	NK cells
AGTGGGAAGCTAGTGG-1	NK cells
ATCATCTGTGTGACGA-1	NK cells
TTTATGCTCTGATTCT-1	NK cells
CAGTCCTTCGAGCCCA-1	NK cells
AGCCTAAAGTGTCTCA-1	NK cells
CAAGTTGGTCCGAGTC-1	NK cells
GCTCTGTTCCCATTAT-1	NK cells
CGGGTCACATCGGGTC-1	NK cells
TTTGCGCGTTACGACT-1	NK cells
GCTCTGTAGTTGTAGA-1	NK cells
TTCTCAAAGGAATCGC-1	NK cells
CCTTCCCGTAGAGCTG-1	NK cells
ATGAGGGTCCGTCATC-1	NK cells
TACTCGCCAGCATGAG-1	NK cells
TCACGAACAGAGCCAA-1	NK cells
TTGCGTCCACTGCCAG-1	NK cells
CTCGGGAAGTCATGCT-1	NK cells
ACCTTTATCTCGTATT-1	NK cells
AGCGGTCCAGCCAATT-1	NK cells
CACTCCACATCCTTGC-1	NK cells
AGTGAGGCAAACTGTC-1	NK cells
GCAGTTAAGCGCCTCA-1	NK cells
GGGAATGGTAAGGGAA-1	NK cells
CAGCTAATCACTCTTA-1	NK cells
TTTACTGCACGGTAAG-1	NK cells
GCAGTTATCTATCCCG-1	NK cells
TAGGCATTCGGTTCGG-1	NK cells
AGACGTTGTTCAGACT-1	NK cells
CGCGTTTAGTCCATAC-1	NK cells
GCATACATCAACCATG-1	NK cells
ACTTACTTCAGTCCCT-1	NK cells
ACGAGCCGTTCATGGT-1	NK cells
CGTTCTGAGGCTCAGA-1	NK cells
TGCCAAAGTGAACCTT-1	NK cells
ACATCAGGTCCGAACC-1	NK cells
TATTACCGTCGCTTTC-1	NK cells
AAGGAGCGTTGCTCCT-1	NK cells
CATGCCTCAAAGTGCG-1	NK cells
GATCGTACATAACCTG-1	NK cells
CAGTAACTCGTTTATC-1	Monocyte
GCACATACATGCGCAC-1	Monocyte
TGCCCATGTAACGTTC-1	Monocyte
CACATTTCACAACGTT-1	Monocyte
CAGGTGCAGATCCCGC-1	Monocyte
GAAGCAGTCACTTACT-1	Monocyte
GGGTTGCAGTGGGCTA-1	Monocyte
ATAGACCCATGGTAGG-1	Monocyte
CACACCTCAGGAATGC-1	Monocyte
TTGACTTCAAAGTCAA-1	Monocyte
GTAACTGCAAACCTAC-1	Monocyte
CGCTTCACAGGCTCAC-1	Monocyte
ACTGATGCACATTCGA-1	Monocyte
AGTTGGTAGTGCAAGC-1	Monocyte
CAGCGACAGTCTCCTC-1	Monocyte
CACACTCAGAACTCGG-1	Monocyte
TCAGCTCAGCCTCGTG-1	Monocyte
GTCATTTGTGTGTGCC-1	Monocyte
CATTCGCAGCTGCGAA-1	Monocyte
AGATTGCGTCAGTGGA-1	Monocyte
GCAGTTAAGCCAGGAT-1	Monocyte
CCTTTCTAGTTCGCGC-1	Monocyte
AGACGTTGTCTGCGGT-1	Monocyte
AATCCAGTCTCGGACG-1	Monocyte
CAGCGACTCACGATGT-1	Monocyte
TCGGTAAGTTAGATGA-1	Monocyte
ATCTGCCTCATTATCC-1	Monocyte
TCAGGATCAGCTCCGA-1	Monocyte
GCTTGAACATGCATGT-1	Monocyte
GTCCTCAGTAAGGGAA-1	Monocyte
TACTCGCGTGGACGAT-1	Monocyte
CTGGTCTAGACAATAC-1	Monocyte
ACGCAGCGTCCTCTTG-1	Lymphatic Endothelial (c6)
ACTTACTCATGCAACT-1	Lymphatic Endothelial (c6)
CCGTACTTCTTTAGTC-1	Lymphatic Endothelial (c6)
GCTTCCAAGTTGAGTA-1	Lymphatic Endothelial (c6)
GTATCTTAGTGGTAAT-1	Lymphatic Endothelial (c6)
AGCTTGATCTTGACGA-1	Lymphatic Endothelial (c6)
TATTACCGTGTTTGTG-1	Lymphatic Endothelial (c6)
ACGGGTCCAGGTGCCT-1	Lymphatic Endothelial (c6)
GGATTACTCAACCATG-1	Lymphatic Endothelial (c6)
GCATACACAGTCGTGC-1	Lymphatic Endothelial (c6)
GTGCATAGTAGCTGCC-1	Lymphatic Endothelial (c6)
TGGACGCTCTAACTTC-1	Lymphatic Endothelial (c6)
AATCCAGGTACGAAAT-1	Lymphatic Endothelial (c6)
TGCCCATTCTAACGGT-1	Lymphatic Endothelial (c6)
GACTACATCGTCCGTT-1	Lymphatic Endothelial (c6)
TGGGCGTAGAAACGAG-1	Lymphatic Endothelial (c6)
CTCGGGATCTATCCTA-1	Lymphatic Endothelial (c6)
GACTGCGAGACCCACC-1	Lymphatic Endothelial (c6)
GGCTCGAGTTACTGAC-1	Lymphatic Endothelial (c6)
TACGGATGTCAAGCGA-1	Lymphatic Endothelial (c6)
CGAGAAGCACACTGCG-1	Lymphatic Endothelial (c6)
CCAATCCGTCAGCTAT-1	Lymphatic Endothelial (c6)
CATCGGGGTATTCTCT-1	Lymphatic Endothelial (c6)
GTATTCTTCGTGGTCG-1	Lymphatic Endothelial (c6)
GTTTCTAAGTATCGAA-1	Lymphatic Endothelial (c6)
CATTATCAGTTAGGTA-1	Lymphatic Endothelial (c6)
CTAACTTCATCCGCGA-1	Lymphatic Endothelial (c6)
ACGGGTCGTCTAGTGT-1	Lymphatic Endothelial (c6)
CTCGTACAGGTGCTAG-1	Lymphatic Endothelial (c6)
CTCTAATAGCTGGAAC-1	Lymphatic Endothelial (c6)
CGGCTAGTCGCCCTTA-1	Lymphatic Endothelial (c6)
CTGTGCTCAGATCCAT-1	Lymphatic Endothelial (c6)
ATAGACCTCTGCGTAA-1	Lymphatic Endothelial (c6)
TCGGGACGTCAACATC-1	Lymphatic Endothelial (c6)
GTTCGGGCATAGAAAC-1	Lymphatic Endothelial (c6)
ACTTACTGTTAAGTAG-1	Lymphatic Endothelial (c6)
AAGGAGCAGCGCTCCA-1	Lymphatic Endothelial (c6)
TAGTGGTTCGCCCTTA-1	Lymphatic Endothelial (c6)
GCTCTGTCATACTACG-1	Lymphatic Endothelial (c6)
ACGGCCAGTGCAACGA-1	Lymphatic Endothelial (c6)
GAGTCCGCAAGAAGAG-1	Lymphatic Endothelial (c6)
AAGACCTGTTTAAGCC-1	Lymphatic Endothelial (c6)
AGGGTGAGTCCAGTGC-1	Lymphatic Endothelial (c6)
TCGTACCGTATAGGGC-1	Lymphatic Endothelial (c6)
AACTCCCGTCTCATCC-1	Lymphatic Endothelial (c6)
TATCAGGTCAACGCTA-1	Lymphatic Endothelial (c6)
TGCTGCTTCAGCTCTC-1	Lymphatic Endothelial (c6)
ACGCAGCTCTTATCTG-1	Lymphatic Endothelial (c6)
ACCGTAATCGTTACAG-1	Lymphatic Endothelial (c6)
ACTGATGTCAACGAAA-1	Lymphatic Endothelial (c6)
CTGAAACCAACACGCC-1	Lymphatic Endothelial (c6)
TAGAGCTAGGAGCGTT-1	Lymphatic Endothelial (c6)
CTCATTAAGGGCACTA-1	Lymphatic Endothelial (c6)
GAACGGACACGGTGTC-1	Lymphatic Endothelial (c6)
CTGAAGTGTGATGTCT-1	Lymphatic Endothelial (c6)
AGAATAGAGCGATATA-1	Lymphatic Endothelial (c6)
GAATGAAAGGGTGTTG-1	Lymphatic Endothelial (c6)
GTCTCGTTCCCTCTTT-1	Lymphatic Endothelial (c6)
GGGCATCGTTCACGGC-1	Lymphatic Endothelial (c6)
TAAGCGTCACTTACGA-1	Lymphatic Endothelial (c6)
GACGGCTTCAGCTCGG-1	Lymphatic Endothelial (c6)
CACATTTGTACTCGCG-1	Lymphatic Endothelial (c6)
CTCGTACAGAGCCTAG-1	Lymphatic Endothelial (c6)
TTGCGTCAGCATCATC-1	Lymphatic Endothelial (c6)
TGCGCAGCAAAGGAAG-1	Lymphatic Endothelial (c6)
TTAGGCAGTGAAATCA-1	Lymphatic Endothelial (c6)
GGGTTGCGTGCAACTT-1	Lymphatic Endothelial (c6)
TCGTAGAAGATTACCC-1	Lymphatic Endothelial (c6)
CTCGGAGAGCTCAACT-1	Lymphatic Endothelial (c6)
GCAGCCACACAGACAG-1	Lymphatic Endothelial (c6)
TACCTATCATAAGACA-1	Lymphatic Endothelial (c6)
TACCTATAGTCCGGTC-1	Lymphatic Endothelial (c6)
TGACAACAGATGCGAC-1	Lymphatic Endothelial (c6)
AAAGCAATCCACGCAG-1	Lymphatic Endothelial (c6)
GTATTCTTCGAATGCT-1	Lymphatic Endothelial (c6)
CGTAGCGTCCCAACGG-1	Lymphatic Endothelial (c6)
ATCATCTAGTACTTGC-1	Lymphatic Endothelial (c6)
GTTACAGTCGGTCCGA-1	Lymphatic Endothelial (c6)
GATGCTACACATCCAA-1	Lymphatic Endothelial (c6)
GCTTGAACAAGCTGGA-1	Lymphatic Endothelial (c6)
CAGCTAAGTGCCTGGT-1	Lymphatic Endothelial (c6)
CGCTTCATCACAGTAC-1	Lymphatic Endothelial (c6)
AAGGCAGCAGTCACTA-1	Lymphatic Endothelial (c6)
AAGGAGCAGACCCACC-1	Lymphatic Endothelial (c6)
CATATGGAGAAAGTGG-1	Lymphatic Endothelial (c6)
CAGCCGAGTTAGATGA-1	Lymphatic Endothelial (c6)
AGTGGGATCGAGGTAG-1	Lymphatic Endothelial (c6)
AGCGTATTCCACTGGG-1	Lymphatic Endothelial (c6)
TGAGCATCAAGAGTCG-1	Lymphatic Endothelial (c6)
ACACCGGTCTTGCCGT-1	Lymphatic Endothelial (c6)
GGAATAATCTGTCTCG-1	Lymphatic Endothelial (c6)
CACCAGGAGGCAAAGA-1	Lymphatic Endothelial (c6)
CGTCTACTCCCAGGTG-1	Lymphatic Endothelial (c6)
ATCTACTGTGTCAATC-1	Lymphatic Endothelial (c6)
CATCGGGTCAAGAAGT-1	Lymphatic Endothelial (c6)
GTTCATTAGCTACCTA-1	Lymphatic Endothelial (c6)
GTAGGCCTCCGTCATC-1	Lymphatic Endothelial (c6)
CTGAAACCATAGGATA-1	Lymphatic Endothelial (c6)
CATGGCGTCTCAAACG-1	Lymphatic Endothelial (c6)
CCACTACAGACTGTAA-1	Lymphatic Endothelial (c6)
GTCTCGTTCTCGATGA-1	Lymphatic Endothelial (c6)
CAGAGAGAGGCGACAT-1	Lymphatic Endothelial (c6)
TTCGGTCCAATGGAAT-1	Lymphatic Endothelial (c7)
TTGGCAAAGTGTACTC-1	Lymphatic Endothelial (c7)
CAGTAACAGCTAACAA-1	Lymphatic Endothelial (c7)
CACACAACACCCAGTG-1	Lymphatic Endothelial (c7)
CTGCGGAAGCAGCCTC-1	Lymphatic Endothelial (c7)
ACATGGTGTGATAAAC-1	Lymphatic Endothelial (c7)
GCTGCTTAGGGAACGG-1	Lymphatic Endothelial (c7)
GTCTCGTGTACCGAGA-1	Lymphatic Endothelial (c7)
ACGATGTTCGCTGATA-1	Lymphatic Endothelial (c7)
TTGGCAACAATAACGA-1	Lymphatic Endothelial (c7)
CTGATCCGTCCGACGT-1	Lymphatic Endothelial (c7)
CGTGTCTAGTAGGTGC-1	Lymphatic Endothelial (c7)
CGTCACTGTCTAGTCA-1	Lymphatic Endothelial (c7)
TGTGTTTTCACGCATA-1	Lymphatic Endothelial (c7)
GTTCATTTCGGAAATA-1	Lymphatic Endothelial (c7)
CCACCTAAGAATCTCC-1	Lymphatic Endothelial (c7)
CGGTTAAAGTGTACGG-1	Lymphatic Endothelial (c7)
TCTCTAAAGATTACCC-1	Lymphatic Endothelial (c7)
GCATGCGTCGAACGGA-1	Lymphatic Endothelial (c7)
TACTCATTCAACTCTT-1	Lymphatic Endothelial (c7)
ACTGCTCGTGACGCCT-1	Lymphatic Endothelial (c7)
CATATTCTCTGGGCCA-1	Lymphatic Endothelial (c7)
TACGGGCCATGAGCGA-1	Lymphatic Endothelial (c7)
TACTCGCGTCCGAATT-1	Lymphatic Endothelial (c7)
GTGAAGGCAGATTGCT-1	Lymphatic Endothelial (c7)
AGCCTAAAGATCCCGC-1	Lymphatic Endothelial (c7)
GATGAAATCCGATATG-1	Lymphatic Endothelial (c7)
GTCTCGTAGCTAAGAT-1	Lymphatic Endothelial (c7)
CGGACGTTCATCGATG-1	Lymphatic Endothelial (c7)
GCTGGGTCAGCTGCTG-1	Lymphatic Endothelial (c7)
AACCGCGAGCTGTCTA-1	Lymphatic Endothelial (c7)
CACCTTGGTCTGATCA-1	Lymphatic Endothelial (c7)
CTCTAATCAAGGACTG-1	Lymphatic Endothelial (c7)
ACGATACAGATGTTAG-1	Lymphatic Endothelial (c7)
TCGTAGACACCATCCT-1	Lymphatic Endothelial (c7)
GAATGAAGTGCACTTA-1	Lymphatic Endothelial (c7)
ATCATGGTCGCAGGCT-1	Lymphatic Endothelial (c7)
AGGTCCGAGTACGATA-1	Lymphatic Endothelial (c7)
GACACGCAGCCGCCTA-1	Lymphatic Endothelial (c7)
TGGGAAGAGGACTGGT-1	Lymphatic Endothelial (c7)
GCCTCTAAGATCCGAG-1	Lymphatic Endothelial (c7)
GCGCCAACACAGGTTT-1	Lymphatic Endothelial (c7)
AGCGGTCTCAAGATCC-1	Lymphatic Endothelial (c7)
AACCATGTCGTAGATC-1	Lymphatic Endothelial (c7)
CTTAACTAGTAGGTGC-1	Lymphatic Endothelial (c7)
GTGTTAGAGAAGATTC-1	Lymphatic Endothelial (c7)
ACGATGTTCGTGGACC-1	Lymphatic Endothelial (c7)
TATCAGGGTAGTAGTA-1	Club Cells
AGCCTAAAGCCGGTAA-1	Club Cells
AGATTGCCATGGTTGT-1	Club Cells
ATTGGACAGCTACCTA-1	Club Cells
ATGAGGGTCTCTGTCG-1	Club Cells
ACTTACTGTTACCAGT-1	Club Cells
ACAGCTACAGATTGCT-1	Club Cells
AACTTTCAGTCGAGTG-1	Club Cells
CGATGGCAGGCCCGTT-1	Club Cells
TGAGCATCAGTCCTTC-1	Club Cells
CGATGGCCATTCGACA-1	Club Cells
CGGACACCAATGAAAC-1	Club Cells
ACAGCCGGTGCACGAA-1	Club Cells
GGTGTTAGTCCGCTGA-1	Club Cells
GCTGCTTGTCCGAATT-1	Club Cells
TGAGCATTCTGATACG-1	Club Cells
GAATAAGCACGGACAA-1	Club Cells
CTAGCCTGTAAGTGGC-1	Club Cells
TAGCCGGAGGATGGTC-1	Club Cells
GCATGATCAATAGAGT-1	Club Cells
AGCTTGATCCTAGAAC-1	Club Cells
CGAGAAGTCCTGCTTG-1	Club Cells
AGCAGCCCACTAGTAC-1	Club Cells
TCAGCAACAAGAGTCG-1	Club Cells
CATGCCTTCTAACTCT-1	Club Cells
TGGCCAGGTCGAACAG-1	Club Cells
GGACGTCTCGGCGGTT-1	Club Cells
TTCGAAGTCCGTCATC-1	Club Cells
CTTACCGGTACGAAAT-1	Club Cells
GCATGCGAGTTCCACA-1	Club Cells
CGTAGGCGTTCCTCCA-1	Club Cells
CACTCCACAGATTGCT-1	Club Cells
AGTTGGTTCCGTTGCT-1	Club Cells
CCGGGATTCACAGTAC-1	Club Cells
GGACGTCCACAACTGT-1	Club Cells
CTCGTACGTGGCAAAC-1	Club Cells
CTACGTCTCCGCATCT-1	Club Cells
ACACCCTGTGCAACTT-1	Club Cells
GTCACGGTCTTCGGTC-1	Club Cells
GCAAACTAGTGAAGTT-1	Ciliated Cells
TCTCTAACAGGAATGC-1	Ciliated Cells
CATTCGCCACCCTATC-1	Ciliated Cells
GCTCCTAGTGCTTCTC-1	Ciliated Cells
CATGCCTGTCGCTTTC-1	Ciliated Cells
GGGAGATGTAAGGGAA-1	Ciliated Cells
CAAGATCAGTGGGATC-1	Ciliated Cells
GACCAATAGAAGAAGC-1	Ciliated Cells
GGTGTTAAGCGTAATA-1	Ciliated Cells
TGAGCATAGCGAAGGG-1	Ciliated Cells
TTGGCAACAGCGATCC-1	Ciliated Cells
TGTGTTTCACAGAGGT-1	Ciliated Cells
CAGCATATCGACAGCC-1	Ciliated Cells
CTAACTTTCATGGTCA-1	Ciliated Cells
GGCGTGTAGAACTGTA-1	Ciliated Cells
CGTGAGCAGTGTGAAT-1	Ciliated Cells
TTGGAACAGGTGGGTT-1	Ciliated Cells
ATCACGATCATTCACT-1	Ciliated Cells
GATTCAGTCAACACGT-1	Ciliated Cells
CGTTCTGAGGCCCTTG-1	Ciliated Cells
GATCAGTCAATGGAGC-1	Ciliated Cells
GTGGGTCTCGAGAACG-1	Ciliated Cells
CATATTCTCCGTCAAA-1	Ciliated Cells
CGTCCATCAGTGGGAT-1	Ciliated Cells
AAAGTAGTCCGTAGTA-1	Ciliated Cells
GCGACCAGTGCTTCTC-1	Ciliated Cells
TGGCGCAGTTCGTCTC-1	Ciliated Cells
TGGCCAGAGTACACCT-1	Ciliated Cells
GTTCTCGTCTACTCAT-1	Ciliated Cells
GTCAAGTCAGTAGAGC-1	Ciliated Cells
TGCGCAGTCTTAACCT-1	Ciliated Cells
GGACAGATCGCTTAGA-1	Ciliated Cells
CATATGGTCGTGGGAA-1	Ciliated Cells
CACCTTGCAGGGTACA-1	Ciliated Cells
AGATCTGGTTGATTCG-1	Ciliated Cells
GTTCTCGCAATTGCTG-1	Ciliated Cells
GGCTCGAAGGTGCTTT-1	Ciliated Cells
GGGTTGCGTTACGTCA-1	Ciliated Cells
ACACCAAAGAAGAAGC-1	Ciliated Cells
CAGCATAAGCCACGCT-1	Ciliated Cells
CGGTTAAGTAGCGTAG-1	Ciliated Cells
AGAGCGATCTGATTCT-1	Ciliated Cells
GTGCGGTTCTGTACGA-1	Ciliated Cells
AACCATGAGGTCATCT-1	Ciliated Cells
CGCTGGATCGTATCAG-1	Ciliated Cells
ACTTGTTAGCTACCGC-1	Ciliated Cells
ACGCCAGTCACCGTAA-1	Ciliated Cells
TTCTCCTTCCTTGGTC-1	Ciliated Cells
GTCGTAACACCTCGTT-1	Endothelial Lymphatic (c10)
CTACACCTCACCTCGT-1	Endothelial Lymphatic (c10)
CTCGGAGCATGTCGAT-1	Endothelial Lymphatic (c10)
CCAATCCAGCTAGTCT-1	Endothelial Lymphatic (c10)
ACTATCTAGCAGATCG-1	Endothelial Lymphatic (c10)
ATCATCTTCGCATGGC-1	Endothelial Lymphatic (c10)
ACGCCAGGTATCAGTC-1	Endothelial Lymphatic (c10)
GATCGCGGTTTGACTG-1	Endothelial Lymphatic (c10)
GGTGAAGGTACGCTGC-1	Endothelial Lymphatic (c10)
GTCTTCGCATGTTGAC-1	Endothelial Lymphatic (c10)
AAGGAGCGTCCTAGCG-1	Endothelial Lymphatic (c10)
CGTGAGCGTTACCAGT-1	Endothelial Lymphatic (c10)
CGTCCATGTTGGTAAA-1	Endothelial Lymphatic (c10)
CGACTTCTCGCTTAGA-1	Endothelial Lymphatic (c10)
CCAATCCAGAGCCTAG-1	Endothelial Lymphatic (c10)
GACCTGGGTGCCTGGT-1	Endothelial Lymphatic (c10)
CGCCAAGCAATGGAGC-1	Endothelial Lymphatic (c10)
GCGCCAAGTGCACGAA-1	Endothelial Lymphatic (c10)
CAAGAAATCATAACCG-1	Endothelial Lymphatic (c10)
CCTTCGAGTATAAACG-1	Endothelial Lymphatic (c10)
GTTTCTAGTCAGTGGA-1	Endothelial Lymphatic (c10)
CCAATCCTCCCACTTG-1	Endothelial Lymphatic (c10)
TGCGTGGGTTACCGAT-1	Endothelial Lymphatic (c10)
CATGACAGTCGAACAG-1	Endothelial Lymphatic (c10)
AGCGTCGTCCAAAGTC-1	Endothelial Lymphatic (c10)
CTCGAAACACGAAATA-1	Endothelial Lymphatic (c10)
CCGTACTAGCTACCGC-1	Endothelial Lymphatic (c10)
GGGAGATGTAAGGGCT-1	Endothelial Lymphatic (c10)
CTGAAGTCACGGACAA-1	Endothelial Lymphatic (c10)
CACACTCGTGCAACTT-1	Endothelial Lymphatic (c10)
GACTACAAGCGCCTCA-1	Endothelial Lymphatic (c10)
CTGTTTATCTGCGGCA-1	Endothelial Lymphatic (c10)
CATTATCAGATATACG-1	Endothelial Lymphatic (c10)
CTCATTACATTGAGCT-1	Endothelial Lymphatic (c10)
AGCGTATGTGCGGTAA-1	Endothelial Lymphatic (c10)
TTAACTCGTACAGTTC-1	Endothelial Lymphatic (c10)
TCTATTGAGTTTGCGT-1	Endothelial Lymphatic (c10)
TCTTCGGAGGGATACC-1	Endothelial Lymphatic (c10)
GCTGCGAAGCCCTAAT-1	Endothelial Lymphatic (c10)
CAGCATATCGTTACAG-1	Endothelial Lymphatic (c10)
GCACTCTGTTAAAGAC-1	Endothelial Lymphatic (c10)
CATTCGCTCTGGAGCC-1	Endothelial Lymphatic (c10)
TTATGCTCATACTACG-1	Endothelial Lymphatic (c10)
ACATGGTTCTGCTGCT-1	Endothelial Lymphatic (c10)
GGGCATCCATCTGGTA-1	Endothelial Lymphatic (c10)
CAAGGCCCAACAACCT-1	Endothelial Lymphatic (c10)
AGAGCTTTCTCGCATC-1	Endothelial Lymphatic (c10)
TGGCCAGCATTCTCAT-1	Endothelial Lymphatic (c10)
TAAGCGTAGATGTTAG-1	Endothelial Lymphatic (c10)
AGTGAGGAGGGAGTAA-1	Endothelial Lymphatic (c10)
GTACGTAGTAAATGAC-1	Endothelial Lymphatic (c10)
GTACTCCAGCTAACTC-1	Endothelial Lymphatic (c10)
AAAGTAGAGATCGGGT-1	Endothelial Lymphatic (c10)
CGGAGTCGTGACGCCT-1	Endothelial Lymphatic (c10)
GTGCGGTCACGAAACG-1	Endothelial Lymphatic (c10)
CGTGTCTAGTGGTAAT-1	Endothelial Lymphatic (c10)
CCCTCCTGTTCTCATT-1	Endothelial Lymphatic (c10)
CCTTTCTTCGGCTACG-1	Endothelial Lymphatic (c10)
CCGTGGATCCACGCAG-1	Endothelial Lymphatic (c10)
CAGAGAGCAAGCGCTC-1	Endothelial Lymphatic (c10)
TATCAGGAGTCTCCTC-1	Endothelial Lymphatic (c10)
CCTTCCCTCCTAGGGC-1	AT2
CCGTTCAAGATGTGGC-1	AT2
CACATAGGTACCGAGA-1	AT2
CGGGTCAGTTCTGTTT-1	AT2
GTGCGGTCAAGACGTG-1	AT2
TATCAGGCATGGGACA-1	AT2
ACGAGGACAGGCTGAA-1	AT2
ACTATCTAGGCTAGGT-1	AT2
CTCAGAAGTCCCTACT-1	AT2
ACTTACTGTTATCCGA-1	Matrix Fibroblasts
AACTCCCTCTGAGGGA-1	Matrix Fibroblasts
CCTCAGTTCTGCGACG-1	Matrix Fibroblasts
CAGCAGCTCCAGAGGA-1	Matrix Fibroblasts
CAGTAACGTGGCAAAC-1	Matrix Fibroblasts
GTACTTTTCGGCCGAT-1	Matrix Fibroblasts
GTATCTTCATTCGACA-1	Matrix Fibroblasts
ACTGAACCATCGGGTC-1	Matrix Fibroblasts
ACGCCGAAGCTGCCCA-1	Matrix Fibroblasts
TACCTATTCCGAACGC-1	Matrix Fibroblasts
CTGATCCTCTTTACAC-1	Matrix Fibroblasts
CCTAAAGTCAGAGACG-1	Matrix Fibroblasts
CTACACCGTCTCACCT-1	Matrix Fibroblasts
CTCTAATAGCGCTTAT-1	Matrix Fibroblasts
TCGTAGACAGTAGAGC-1	Matrix Fibroblasts
CGTCCATTCGCATGGC-1	Matrix Fibroblasts
ATTTCTGCAATCGAAA-1	Matrix Fibroblasts
TTGGAACCAATCCAAC-1	Matrix Fibroblasts
CTAGTGAGTGAGGGAG-1	Matrix Fibroblasts
CTGCGGAAGTTTAGGA-1	Matrix Fibroblasts
TCAGGTAAGATGGCGT-1	Matrix Fibroblasts
TCGCGTTTCTCGTATT-1	Matrix Fibroblasts
GGCGTGTCATGGAATA-1	Matrix Fibroblasts
CGCGTTTCACCCATTC-1	Matrix Fibroblasts
CTCGAGGTCGCATGAT-1	Matrix Fibroblasts
TCAACGAAGCGTAGTG-1	Matrix Fibroblasts
CTCGAAAAGCTCCTCT-1	Matrix Fibroblasts
CCCAGTTTCAGCATGT-1	Matrix Fibroblasts
GTCATTTAGAGGGATA-1	Matrix Fibroblasts
CTCTGGTTCTATGTGG-1	Matrix Fibroblasts
TGACGGCGTCGCATCG-1	Matrix Fibroblasts
TAAACCGTCTTGGGTA-1	Matrix Fibroblasts
ACTGAGTAGAGTCTGG-1	Matrix Fibroblasts
GCTCTGTTCGCGGATC-1	Matrix Fibroblasts
GTTTCTAGTCCGCTGA-1	Matrix Fibroblasts
GAACATCCACCTGGTG-1	Matrix Fibroblasts
TACTCATTCAATCTCT-1	Matrix Fibroblasts
AGAGCTTCATCGACGC-1	Matrix Fibroblasts
GACGCGTGTTCAGCGC-1	Matrix Fibroblasts
ATCGAGTGTGTTTGGT-1	Matrix Fibroblasts
GCTCTGTCATCGGACC-1	Matrix Fibroblasts
CGTTCTGAGGCTACGA-1	Matrix Fibroblasts
ATCATGGCAGCATGAG-1	Matrix Fibroblasts
CTACCCACATATGCTG-1	Matrix Fibroblasts
CCATTCGGTACCGCTG-1	Matrix Fibroblasts
CAAGATCGTTGACGTT-1	Matrix Fibroblasts
AGTGTCATCTCGAGTA-1	Matrix Fibroblasts
CTCGAAACACAAGTAA-1	Matrix Fibroblasts
TTTCCTCTCGTTACAG-1	Matrix Fibroblasts
CGGGTCAAGGATCGCA-1	Matrix Fibroblasts
CCTCTGATCACGAAGG-1	Matrix Fibroblasts
ATCACGAAGAGCTTCT-1	Matrix Fibroblasts
CTCGGGATCCTCGCAT-1	Matrix Fibroblasts
TCAATCTAGTCAAGCG-1	Matrix Fibroblasts
GGCCGATTCCGCATCT-1	Matrix Fibroblasts
CCTTACGCATTGGGCC-1	Matrix Fibroblasts
TCAGATGGTAAGAGGA-1	Matrix Fibroblasts
ATGTGTGAGGCTACGA-1	Matrix Fibroblasts
TGCCAAAAGATCCTGT-1	Matrix Fibroblasts
GTCACGGCAAGGCTCC-1	Matrix Fibroblasts
CTAGTGAAGTCCCACG-1	Matrix Fibroblasts
ACTGCTCAGTCTCAAC-1	Matrix Fibroblasts
CGGACACCACACTGCG-1	Matrix Fibroblasts
AGCTCCTCACCACGTG-1	Matrix Fibroblasts
AATCGGTTCTGGCGTG-1	Matrix Fibroblasts
CGTGTAATCACTGGGC-1	Matrix Fibroblasts
TTAGTTCTCGTACGGC-1	Matrix Fibroblasts
CGCTGGATCGGCGCAT-1	Matrix Fibroblasts
GGTGTTAAGTTGAGAT-1	Matrix Fibroblasts
TGACGGCAGGCAGGTT-1	Matrix Fibroblasts
AACTCAGGTTTAGCTG-1	Matrix Fibroblasts
GATCTAGCAAGGGTCA-1	Matrix Fibroblasts
GGAATAATCTTTACGT-1	Matrix Fibroblasts
AAGGAGCAGTGCCAGA-1	Matrix Fibroblasts
CCTTACGGTACAGTTC-1	Matrix Fibroblasts
TACCTATTCGTAGGTT-1	Matrix Fibroblasts
CTGAAACAGCGCTCCA-1	Matrix Fibroblasts
GATGAAAAGTTGAGAT-1	Matrix Fibroblasts
ACAGCTATCACAAACC-1	Matrix Fibroblasts
TTGAACGGTGCAACTT-1	Matrix Fibroblasts
GCGCAGTGTCTCATCC-1	Matrix Fibroblasts
CTACACCCAGCATGAG-1	Matrix Fibroblasts
CGACCTTAGTACATGA-1	Matrix Fibroblasts
CTGAAACAGACAAAGG-1	Matrix Fibroblasts
CGAGCACGTAGGCTGA-1	Matrix Fibroblasts
TTTATGCTCCACGACG-1	Matrix Fibroblasts
TGCGTGGGTCGAGTTT-1	Matrix Fibroblasts
CACCAGGAGCTAGTCT-1	Matrix Fibroblasts
CAGATCACATGCCTAA-1	Matrix Fibroblasts
GGTATTGCAACGCACC-1	Matrix Fibroblasts
CATATGGTCGAATCCA-1	Matrix Fibroblasts
GGCCGATCAATGCCAT-1	Matrix Fibroblasts
GACGTGCGTATAGTAG-1	Matrix Fibroblasts
TGGCGCAAGAGGGCTT-1	Matrix Fibroblasts
TACGGGCCACTTAACG-1	Matrix Fibroblasts
GAATAAGAGTTAGCGG-1	Matrix Fibroblasts
CTTACCGGTGTGGTTT-1	Matrix Fibroblasts
TTTGCGCCAAGTAATG-1	Matrix Fibroblasts
GTAGGCCCATGGGACA-1	Matrix Fibroblasts
AAGGAGCGTCTAGAGG-1	Matrix Fibroblasts
CAGCCGATCCGCTGTT-1	Matrix Fibroblasts
TCAACGATCCTGTAGA-1	Matrix Fibroblasts
TCACGAAGTCTACCTC-1	Matrix Fibroblasts
CACAGGCAGAACAATC-1	Matrix Fibroblasts
CCAGCGAGTAAGAGGA-1	Matrix Fibroblasts
CGTGTCTTCCCAAGAT-1	Matrix Fibroblasts
CTACGTCAGGCCCTTG-1	Matrix Fibroblasts
TCCCGATAGTCTTGCA-1	Matrix Fibroblasts
AACTCCCGTATAGTAG-1	Matrix Fibroblasts
CTAGTGAAGCAACGGT-1	Matrix Fibroblasts
CTTAACTAGGGATCTG-1	Matrix Fibroblasts
TGAAAGATCCGTTGTC-1	Matrix Fibroblasts
TCAGGATCACGTCTCT-1	Matrix Fibroblasts
GTGCAGCAGAGGGCTT-1	Matrix Fibroblasts
CAGCGACTCCTCCTAG-1	Matrix Fibroblasts
CCCAATCCACCATGTA-1	Matrix Fibroblasts
CTAATGGGTCGATTGT-1	Matrix Fibroblasts
TGAGCATAGGAGCGAG-1	Matrix Fibroblasts
GACTGCGGTTGGTGGA-1	Matrix Fibroblasts
CGTTGGGAGCGGATCA-1	Matrix Fibroblasts
CCTATTATCGGTGTTA-1	Matrix Fibroblasts
GTGTTAGAGGATGCGT-1	Matrix Fibroblasts
GCTCCTACATCGGGTC-1	Matrix Fibroblasts
ACTGAGTGTTAAGGGC-1	Matrix Fibroblasts
GAGTCCGGTAGCGCAA-1	Matrix Fibroblasts
TATCAGGGTTCGCTAA-1	Matrix Fibroblasts
TTATGCTAGACTGGGT-1	Matrix Fibroblasts
CAACCTCAGCGTAGTG-1	Matrix Fibroblasts
GCAAACTTCCGTTGCT-1	Matrix Fibroblasts
GAGTCCGTCCAAACAC-1	Matrix Fibroblasts
TGAGCCGGTTCGGGCT-1	Matrix Fibroblasts
CCTTCGAAGTGGGATC-1	Matrix Fibroblasts
CTGCGGATCGATAGAA-1	Matrix Fibroblasts
TGCACCTTCTCTTATG-1	Matrix Fibroblasts
GTGCTTCGTTTCGCTC-1	Matrix Fibroblasts
CGCGTTTAGTGAAGAG-1	Matrix Fibroblasts
CATGCCTAGAACAACT-1	Matrix Fibroblasts
CATGACACAAACGTGG-1	Matrix Fibroblasts
CCTTTCTAGCTAACAA-1	Matrix Fibroblasts
TGCACCTAGTGGGATC-1	Matrix Fibroblasts
TTCGGTCCATAGACTC-1	Matrix Fibroblasts
ACTGAACCAGCTCGAC-1	Matrix Fibroblasts
TCGTACCGTAACGACG-1	Matrix Fibroblasts
TTTGTCATCCATGAAC-1	Matrix Fibroblasts
TTGGCAAAGTGGGATC-1	Matrix Fibroblasts
AGGGTGAGTCTCATCC-1	Matrix Fibroblasts
AGGGTGATCTGTACGA-1	Matrix Fibroblasts
CGAGCCAGTGCAACGA-1	Matrix Fibroblasts
CATATGGCATCCCACT-1	Matrix Fibroblasts
TCCCGATTCTGGTATG-1	Matrix Fibroblasts
ACTTACTTCTTTACAC-1	Matrix Fibroblasts
CTCACACTCTTCTGGC-1	Matrix Fibroblasts
GACCAATAGCTGCGAA-1	Matrix Fibroblasts
ACATGGTGTTACGGAG-1	Matrix Fibroblasts
ACGCCAGGTCTGCCAG-1	Matrix Fibroblasts
CCTTCCCCAGTTAACC-1	Matrix Fibroblasts
AAGGTTCCACCAACCG-1	Matrix Fibroblasts
TTGGAACGTTAAGATG-1	Matrix Fibroblasts
GAATGAACAAAGTCAA-1	Matrix Fibroblasts
CCACTACTCGTGGTCG-1	Matrix Fibroblasts
TAAGTGCAGGTAAACT-1	Matrix Fibroblasts
TTCGGTCAGTGGCACA-1	Matrix Fibroblasts
TCAGGTATCGTGGACC-1	Matrix Fibroblasts
TACTCGCGTCCGAACC-1	Matrix Fibroblasts
ATTATCCAGGTCGGAT-1	Matrix Fibroblasts
ACTGAACAGGGATCTG-1	Matrix Fibroblasts
GACCTGGCAGGAACGT-1	Matrix Fibroblasts
CACACCTGTTCTCATT-1	Matrix Fibroblasts
TCAGGATTCGGTCTAA-1	Matrix Fibroblasts
TCGGGACTCAGTCAGT-1	Matrix Fibroblasts
TGAGGGAGTCGTGGCT-1	Matrix Fibroblasts
AGGCCGTCAGTGGAGT-1	Matrix Fibroblasts
ATAGACCCACGTCAGC-1	Matrix Fibroblasts
CGCTATCGTAAACCTC-1	Matrix Fibroblasts
CGTTCTGCATTCCTCG-1	Matrix Fibroblasts
GGCCGATTCTGATACG-1	Matrix Fibroblasts
GCAGCCAGTGACCAAG-1	Matrix Fibroblasts
GATCGATTCAGCATGT-1	Matrix Fibroblasts
TGAGCCGCAAAGCAAT-1	Matrix Fibroblasts
AGGGTGAGTAAGTGTA-1	Matrix Fibroblasts
GCTGCAGTCGTTGACA-1	Matrix Fibroblasts
CCGTTCACAAGCGTAG-1	Matrix Fibroblasts
CTCAGAATCCTCAACC-1	Matrix Fibroblasts
GTATCTTAGCGATCCC-1	Matrix Fibroblasts
CACCTTGAGATCCCGC-1	Matrix Fibroblasts
GCTCTGTAGGGCTTCC-1	Matrix Fibroblasts
ATTGGTGTCGCCGTGA-1	Matrix Fibroblasts
ATTGGTGGTTGGTTTG-1	Matrix Fibroblasts
GATCGATAGGGAAACA-1	Matrix Fibroblasts
AAAGTAGCATACTCTT-1	Matrix Fibroblasts
GAACGGACATCACCCT-1	Matrix Fibroblasts
GACTACAGTAATTGGA-1	Matrix Fibroblasts
CTAAGACAGCGATCCC-1	Matrix Fibroblasts
TCGTACCTCGTGGGAA-1	Matrix Fibroblasts
GTTCATTGTGGCAAAC-1	Matrix Fibroblasts
GACGCGTTCTTGACGA-1	Matrix Fibroblasts
CAGCCGAGTCACTGGC-1	Matrix Fibroblasts
CGATTGATCTCTTGAT-1	Matrix Fibroblasts
GGACGTCTCATCACCC-1	Matrix Fibroblasts
TTCTCAAAGCGTTTAC-1	Matrix Fibroblasts
CGTCCATCATGGTCAT-1	Matrix Fibroblasts
ACTGCTCAGAAGGCCT-1	Matrix Fibroblasts
ATTCTACTCTGCCCTA-1	Matrix Fibroblasts
CTACCCACATACGCCG-1	Matrix Fibroblasts
TAGTTGGTCAAACCGT-1	Matrix Fibroblasts
CCAATCCCACAGGTTT-1	Matrix Fibroblasts
CTGCTGTAGTGCGTGA-1	Matrix Fibroblasts
TGGGAAGTCTGTCTCG-1	Matrix Fibroblasts
ACTTGTTAGCCCAGCT-1	Matrix Fibroblasts
TCAACGATCGAGGTAG-1	Matrix Fibroblasts
GCATGTAGTGTTAAGA-1	Matrix Fibroblasts
ACAGCTATCAGTTAGC-1	Matrix Fibroblasts
AATCCAGGTTCCATGA-1	Matrix Fibroblasts
TACAGTGCAGGGTTAG-1	Matrix Fibroblasts
TCTTTCCTCAACGCTA-1	Matrix Fibroblasts
TGCACCTGTCGCCATG-1	Matrix Fibroblasts
AGGTCCGCACCGTTGG-1	Matrix Fibroblasts
CCACTACAGCCGGTAA-1	Matrix Fibroblasts
AGTAGTCGTTACCAGT-1	Matrix Fibroblasts
TACACGACAGTGAGTG-1	Matrix Fibroblasts
TTATGCTCAGATGGCA-1	Matrix Fibroblasts
TATCTCAGTTGGAGGT-1	Matrix Fibroblasts
CGATTGATCTGGCGTG-1	Matrix Fibroblasts
CTGTTTAAGATCCCAT-1	Matrix Fibroblasts
CAGCTAACACGTTGGC-1	Matrix Fibroblasts
TAAGTGCGTAGCTAAA-1	Matrix Fibroblasts
GGAACTTCATACGCTA-1	Matrix Fibroblasts
TGCCAAACAGGCTGAA-1	Matrix Fibroblasts
CGAATGTAGGGAACGG-1	Matrix Fibroblasts
CAGAGAGAGCTGCAAG-1	Matrix Fibroblasts
CGACCTTAGTGAAGTT-1	Matrix Fibroblasts
CGTTAGATCCAAATGC-1	Matrix Fibroblasts
GGTGAAGTCTTGTTTG-1	Matrix Fibroblasts
GTCATTTTCTACTATC-1	Matrix Fibroblasts
ATCCGAACAGGCGATA-1	Matrix Fibroblasts
TGACTAGCACGGTAAG-1	Matrix Fibroblasts
GCGAGAACACACATGT-1	Matrix Fibroblasts
TCGAGGCAGACACTAA-1	Matrix Fibroblasts
CAGCTGGTCACTCTTA-1	Matrix Fibroblasts
ATCTGCCAGACTGTAA-1	Matrix Fibroblasts
GTGTGCGAGCTGTCTA-1	Matrix Fibroblasts
GTAGGCCGTTATGTGC-1	Matrix Fibroblasts
GGTGCGTGTCGGCACT-1	Matrix Fibroblasts
CCTAAAGAGTGTCCAT-1	Matrix Fibroblasts
CGTCCATAGGGTATCG-1	Matrix Fibroblasts
CAAGTTGTCTCCCTGA-1	Matrix Fibroblasts
GACAGAGGTCTCTCTG-1	Matrix Fibroblasts
CGCGGTAGTCAAACTC-1	Matrix Fibroblasts
TTCTTAGAGGCAATTA-1	Matrix Fibroblasts
GTGTTAGGTTCAGTAC-1	Matrix Fibroblasts
GAACATCGTCCGCTGA-1	Matrix Fibroblasts
TATGCCCAGGATGTAT-1	Matrix Fibroblasts
CTCGTACCACCTGGTG-1	Matrix Fibroblasts
TATCTCATCTGCTGTC-1	Matrix Fibroblasts
AGTGGGACATGGTTGT-1	Matrix Fibroblasts
GGACAAGGTCGCCATG-1	Matrix Fibroblasts
CTAACTTCAGTTTACG-1	Matrix Fibroblasts
CAACTAGGTGACTCAT-1	Matrix Fibroblasts
ATCGAGTGTAGAAGGA-1	Matrix Fibroblasts
CTAAGACCAGTAAGCG-1	Matrix Fibroblasts
CTCCTAGGTTCCGTCT-1	Matrix Fibroblasts
GCCAAATTCACCCTCA-1	Matrix Fibroblasts
CTGGTCTAGCTAAACA-1	Matrix Fibroblasts
TCATTTGTCCGCGGTA-1	Matrix Fibroblasts
TTTGCGCAGACTCGGA-1	Matrix Fibroblasts
CGGACTGTCATGTCCC-1	Matrix Fibroblasts
AACTTTCTCGCATGGC-1	Matrix Fibroblasts
TGCTACCGTACGCACC-1	Matrix Fibroblasts
GAACGGATCCACGCAG-1	Matrix Fibroblasts
CCCAGTTCAGCTGTTA-1	Matrix Fibroblasts
CTACATTAGTGCGATG-1	Matrix Fibroblasts
CCAGCGAGTTAGTGGG-1	Matrix Fibroblasts
TGCACCTAGTGCCATT-1	Matrix Fibroblasts
ACGGCCAGTCCGTCAG-1	Matrix Fibroblasts
ATCTACTCATTTGCTT-1	Matrix Fibroblasts
CGATGGCCATGTCTCC-1	Matrix Fibroblasts
TAAGAGAAGGACATTA-1	Matrix Fibroblasts
ATAAGAGGTTGATTGC-1	Matrix Fibroblasts
CGGAGTCTCGTAGGAG-1	Matrix Fibroblasts
AGGCCGTAGTTACCCA-1	Matrix Fibroblasts
AGATCTGGTCGCTTTC-1	Matrix Fibroblasts
ACCGTAAAGTTCGCGC-1	Matrix Fibroblasts
CTCGGGACAAGTCTGT-1	Matrix Fibroblasts
GCAATCAGTGGTTTCA-1	Matrix Fibroblasts
GACAGAGGTTGGTGGA-1	Matrix Fibroblasts
CCGTACTTCTTGAGAC-1	Matrix Fibroblasts
CTACGTCTCGGTGTTA-1	Matrix Fibroblasts
TTGAACGGTAGAGTGC-1	Matrix Fibroblasts
CGATGGCTCGCTTAGA-1	Matrix Fibroblasts
GATCGATGTAAGTGGC-1	Matrix Fibroblasts
CCGTACTCATGTAAGA-1	Matrix Fibroblasts
TTTACTGTCAGGCCCA-1	Matrix Fibroblasts
ACACCCTCACATGGGA-1	Matrix Fibroblasts
CGGAGTCGTTCATGGT-1	Matrix Fibroblasts
CTCGAAAAGCTCAACT-1	Matrix Fibroblasts
TACCTATTCATACGGT-1	Matrix Fibroblasts
AAAGCAAGTAGCTCCG-1	Matrix Fibroblasts
GCTGCTTTCATCACCC-1	Matrix Fibroblasts
AGTGAGGCACATTTCT-1	Matrix Fibroblasts
ACCTTTAAGCCAACAG-1	Matrix Fibroblasts
ACACCAACACAGGCCT-1	Matrix Fibroblasts
CTGATAGCATAGGATA-1	Matrix Fibroblasts
CGTCTACGTTCTGGTA-1	Matrix Fibroblasts
CCTAAAGTCCAGAAGG-1	Matrix Fibroblasts
AATCCAGCATTAACCG-1	Matrix Fibroblasts
TACTCATTCTGTCTCG-1	Matrix Fibroblasts
GCGCAGTCAATAGCGG-1	Matrix Fibroblasts
TTTGGTTGTGGTAACG-1	Matrix Fibroblasts
CGTGAGCGTGCTAGCC-1	Matrix Fibroblasts
TTATGCTTCATGTCCC-1	Matrix Fibroblasts
CTAGAGTCATTCCTCG-1	Matrix Fibroblasts
CCGGGATCATGGTAGG-1	Matrix Fibroblasts
TATCAGGCATAGGATA-1	Matrix Fibroblasts
TCTGAGAAGAAGGACA-1	Matrix Fibroblasts
CCACTACGTCGAGATG-1	Matrix Fibroblasts
GGGAGATTCACGCGGT-1	Matrix Fibroblasts
CGATGGCCAAGAAGAG-1	Matrix Fibroblasts
ATAAGAGTCTGTCTAT-1	Matrix Fibroblasts
TGAGCATTCCAAATGC-1	Matrix Fibroblasts
ATAAGAGTCAGGCGAA-1	Matrix Fibroblasts
TGGTTCCGTTTGACAC-1	Matrix Fibroblasts
ACGATACGTGATGTCT-1	Matrix Fibroblasts
GGGCACTGTAAGTTCC-1	Matrix Fibroblasts
AGCAGCCTCTCTAGGA-1	Matrix Fibroblasts
AGGCCGTAGGACTGGT-1	Matrix Fibroblasts
GGTGTTAAGCTAGTGG-1	Matrix Fibroblasts
CTTAGGAAGCTGCGAA-1	Matrix Fibroblasts
ACATGGTGTAGCGTCC-1	Matrix Fibroblasts
CGTGTAAGTACATGTC-1	Matrix Fibroblasts
GCATGATGTCCGAATT-1	Matrix Fibroblasts
CGCTATCAGGATGGAA-1	Matrix Fibroblasts
AAGACCTCATTATCTC-1	Matrix Fibroblasts
CACAGGCCATACTCTT-1	Matrix Fibroblasts
ATCACGAAGACAGAGA-1	Matrix Fibroblasts
TCACAAGGTATAATGG-1	Matrix Fibroblasts
TTCTACAGTCTAGTCA-1	Matrix Fibroblasts
TGCGCAGGTAAGGATT-1	Matrix Fibroblasts
AGCTCTCTCAGTACGT-1	Matrix Fibroblasts
GGCGACTAGGGCTTCC-1	Matrix Fibroblasts
CCTAAAGCACATTAGC-1	Matrix Fibroblasts
ATTCTACCATGGTCTA-1	Matrix Fibroblasts
TCCCGATCACCCATTC-1	Matrix Fibroblasts
GATCTAGGTTGGACCC-1	Matrix Fibroblasts
AGCGTATCATGCCTAA-1	Matrix Fibroblasts
GTCGTAACAGATAATG-1	Matrix Fibroblasts
GGACGTCGTAAGTGTA-1	Matrix Fibroblasts
GACCTGGAGACTACAA-1	Matrix Fibroblasts
AGGGTGATCTAACTGG-1	Matrix Fibroblasts
CACTCCAGTTCAGTAC-1	Matrix Fibroblasts
GCCTCTAAGCTGATAA-1	Matrix Fibroblasts
CGCTGGACAGGGCATA-1	Matrix Fibroblasts
GTCTCGTTCTCAAACG-1	Matrix Fibroblasts
CGTCAGGAGGAGTTGC-1	Matrix Fibroblasts
TACCTTACAGGTCCAC-1	Matrix Fibroblasts
ATCTACTAGCGGATCA-1	Matrix Fibroblasts
CCAGCGAGTCGAATCT-1	Matrix Fibroblasts
AGATTGCAGGCATGGT-1	Matrix Fibroblasts
AGGGAGTGTGTCCTCT-1	Matrix Fibroblasts
GCAAACTAGACGACGT-1	Matrix Fibroblasts
CTGCCTACAGACACTT-1	Matrix Fibroblasts
AAACCTGAGTATTGGA-1	Matrix Fibroblasts
TTATGCTTCAAACGGG-1	Matrix Fibroblasts
TTAGGCAGTAAGAGAG-1	Matrix Fibroblasts
ACGGCCAAGCAGATCG-1	Matrix Fibroblasts
TCGCGAGGTGAGGCTA-1	Matrix Fibroblasts
GAGCAGAAGTCCATAC-1	Matrix Fibroblasts
AGGGATGAGACAGACC-1	Matrix Fibroblasts
TTTCCTCAGACACGAC-1	Matrix Fibroblasts
CAAGGCCTCTGCAGTA-1	Matrix Fibroblasts
CTAGCCTGTAGCCTCG-1	Matrix Fibroblasts
CCATTCGGTTCCAACA-1	Matrix Fibroblasts
ACCGTAATCCTCAATT-1	Matrix Fibroblasts
AGGTCATAGCGTGAAC-1	Matrix Fibroblasts
CAAGAAACACGGTGTC-1	Matrix Fibroblasts
AGCGGTCAGGATGTAT-1	Matrix Fibroblasts
GCTGCAGCAGCTGCTG-1	Matrix Fibroblasts
TGGACGCGTCTCCACT-1	Matrix Fibroblasts
GACTGCGAGCCCAATT-1	Matrix Fibroblasts
CAAGATCAGGAGTACC-1	Matrix Fibroblasts
CGTAGCGGTCTAGTCA-1	Matrix Fibroblasts
TCAGCTCAGCGATCCC-1	Matrix Fibroblasts
CCTTTCTGTTCCATGA-1	Matrix Fibroblasts
CAGAGAGTCGTTTGCC-1	Matrix Fibroblasts
CTCGTCACAGCTGTGC-1	Matrix Fibroblasts
CACAAACGTGTGACGA-1	Matrix Fibroblasts
GTACTCCGTCGTCTTC-1	Matrix Fibroblasts
CTTCTCTTCACGAAGG-1	Matrix Fibroblasts
GACTACACATTAGCCA-1	Matrix Fibroblasts
TAAGTGCTCCGTAGTA-1	Matrix Fibroblasts
CAGTAACTCAATCTCT-1	Matrix Fibroblasts
ACTTGTTCAGCTGCTG-1	Matrix Fibroblasts
CCTACCAGTTACCGAT-1	Matrix Fibroblasts
CCTAAAGAGCACAGGT-1	Matrix Fibroblasts
AGAGCTTCACATTTCT-1	Matrix Fibroblasts
CACAGTACATACAGCT-1	Matrix Fibroblasts
GCTGCAGAGTCGAGTG-1	Matrix Fibroblasts
ACTTTCATCTCGATGA-1	Matrix Fibroblasts
TAGAGCTTCTGGTATG-1	Matrix Fibroblasts
GTCTCGTTCAGCATGT-1	Matrix Fibroblasts
ATCGAGTGTAAGTTCC-1	Matrix Fibroblasts
ATCACGAAGCGAGAAA-1	Matrix Fibroblasts
GGCAATTTCTCCAACC-1	Matrix Fibroblasts
GGACGTCTCTCTTGAT-1	Matrix Fibroblasts
AGTGAGGCAGCTGTAT-1	Matrix Fibroblasts
CATCGAATCTCTGCTG-1	Matrix Fibroblasts
GCGCAACAGCACGCCT-1	Matrix Fibroblasts
TCGTACCCATGTCTCC-1	Matrix Fibroblasts
AACGTTGGTCCGAATT-1	Matrix Fibroblasts
GGCCGATCACCTGGTG-1	Matrix Fibroblasts
GATCGTAGTCATGCAT-1	Matrix Fibroblasts
GACGGCTAGTACTTGC-1	Matrix Fibroblasts
CTGATCCGTTCCATGA-1	Matrix Fibroblasts
TAGACCACAATCCAAC-1	Matrix Fibroblasts
AGGGAGTCACCGAATT-1	Matrix Fibroblasts
CGTTGGGCAGGATTGG-1	Matrix Fibroblasts
GAAGCAGTCCCTGACT-1	Matrix Fibroblasts
ATCTACTGTAAGTTCC-1	Matrix Fibroblasts
AGAGTGGCAAAGCGGT-1	Matrix Fibroblasts
CAGCTAATCTTTAGTC-1	Matrix Fibroblasts
CAGCTAAGTTCGCTAA-1	Matrix Fibroblasts
TATGCCCGTGTTGGGA-1	Matrix Fibroblasts
TTCCCAGGTGTGCCTG-1	Matrix Fibroblasts
GTGCTTCTCCACTCCA-1	Matrix Fibroblasts
ATCCACCGTCCGAGTC-1	Matrix Fibroblasts
TTGGCAACAGTAACGG-1	Matrix Fibroblasts
TAGCCGGCACATTAGC-1	Matrix Fibroblasts
GCGCGATGTAATTGGA-1	Matrix Fibroblasts
GGTGAAGAGGACCACA-1	Matrix Fibroblasts
ATAACGCGTGCCTGCA-1	Matrix Fibroblasts
GACGCGTCAGCTGTAT-1	Matrix Fibroblasts
TGAGGGACATCCGGGT-1	Matrix Fibroblasts
CATCGAACACAACGTT-1	Matrix Fibroblasts
CGAACATGTTATCGGT-1	Matrix Fibroblasts
TCCCGATTCTTGCCGT-1	Matrix Fibroblasts
ACTGAGTAGGTGGGTT-1	Matrix Fibroblasts
GACGCGTTCTGACCTC-1	Matrix Fibroblasts
CGAGAAGTCTGACCTC-1	Matrix Fibroblasts
TGCGTGGTCTACGAGT-1	Matrix Fibroblasts
CGCGTTTAGTCGTACT-1	Matrix Fibroblasts
GATGAGGGTCCAACTA-1	Matrix Fibroblasts
GGGACCTTCTTTACGT-1	Matrix Fibroblasts
AAAGATGGTAAGTGGC-1	Matrix Fibroblasts
CGACTTCTCTGCGGCA-1	Matrix Fibroblasts
CTTACCGAGCCCAGCT-1	Matrix Fibroblasts
TGCCAAAAGCGCTTAT-1	Matrix Fibroblasts
CGTTGGGTCCTCCTAG-1	Matrix Fibroblasts
CTTTGCGTCTGATACG-1	Matrix Fibroblasts
GAATGAACAGCGTCCA-1	Matrix Fibroblasts
CTCCTAGCACCTGGTG-1	Matrix Fibroblasts
CATGCCTTCAGTTGAC-1	Matrix Fibroblasts
GTGCGGTCATACGCCG-1	Matrix Fibroblasts
TGAGAGGAGTTCCACA-1	Matrix Fibroblasts
GAGTCCGGTTTGGGCC-1	Matrix Fibroblasts
TAGAGCTTCGAATGCT-1	Matrix Fibroblasts
GGTGTTATCGAGCCCA-1	Matrix Fibroblasts
ACATCAGAGTGTTGAA-1	Matrix Fibroblasts
CGGTTAAGTTCTCATT-1	Matrix Fibroblasts
CACCTTGTCTTAACCT-1	Matrix Fibroblasts
TTTATGCAGCGGCTTC-1	Matrix Fibroblasts
ACGAGGAGTAGCAAAT-1	Matrix Fibroblasts
GGGCATCAGGGAGTAA-1	Matrix Fibroblasts
TCAGCTCAGAGGGCTT-1	Matrix Fibroblasts
TAAGAGAGTCTAGTGT-1	Matrix Fibroblasts
CCACCTATCCTTTACA-1	Matrix Fibroblasts
GCACTCTAGTGTTAGA-1	Matrix Fibroblasts
TGCCCTAAGCCAGTTT-1	Matrix Fibroblasts
CCTTACGTCTCGATGA-1	Matrix Fibroblasts
GGGCATCTCATCGGAT-1	Matrix Fibroblasts
CGGTTAAAGTGTACCT-1	Matrix Fibroblasts
ATCATCTCAACACCCG-1	Matrix Fibroblasts
CCACTACTCTAACGGT-1	Matrix Fibroblasts
TATTACCTCTGCAAGT-1	Matrix Fibroblasts
GCTTGAAAGCCGTCGT-1	Matrix Fibroblasts
ACATACGCACCGCTAG-1	Matrix Fibroblasts
ACACCCTCAAGCGTAG-1	Matrix Fibroblasts
GTGAAGGCACTTACGA-1	Matrix Fibroblasts
CTGAAACCACATCCAA-1	Matrix Fibroblasts
GATGAGGAGCGTGAAC-1	Matrix Fibroblasts
GAATGAATCCAGTATG-1	Matrix Fibroblasts
CTTTGCGTCACAACGT-1	Matrix Fibroblasts
CTCACACAGATGCCAG-1	Matrix Fibroblasts
ATGTGTGAGTGACTCT-1	Matrix Fibroblasts
CTGATCCTCGTAGATC-1	Matrix Fibroblasts
ATCTACTGTGTTCTTT-1	Matrix Fibroblasts
TAAGAGACATAGGATA-1	Matrix Fibroblasts
GGACAGAAGCACACAG-1	Matrix Fibroblasts
GACTACATCAGCTCGG-1	Matrix Fibroblasts
CTCGTCATCCATTCTA-1	Matrix Fibroblasts
TCATTTGCAGGCGATA-1	Matrix Fibroblasts
ACCTTTATCAACTCTT-1	Matrix Fibroblasts
CACAGTAGTACAGCAG-1	Matrix Fibroblasts
CTAGAGTGTCATGCAT-1	Matrix Fibroblasts
TACCTTAAGCCAACAG-1	Matrix Fibroblasts
CTCGAGGGTCAGATAA-1	Matrix Fibroblasts
TAGTTGGCACCAGTTA-1	Matrix Fibroblasts
CGTCAGGAGTCAAGCG-1	Matrix Fibroblasts
CACCTTGAGATGTAAC-1	Matrix Fibroblasts
GCTCCTATCCACGTGG-1	Matrix Fibroblasts
TAGTGGTCATCCCACT-1	Matrix Fibroblasts
AGGCCGTTCGGAAATA-1	Matrix Fibroblasts
TCATTTGTCTTGTATC-1	Matrix Fibroblasts
ACACCGGCACGAAGCA-1	Matrix Fibroblasts
ACGGGCTTCCGTTGTC-1	Matrix Fibroblasts
CGCGTTTTCACTATTC-1	Matrix Fibroblasts
TTGGAACGTGAAAGAG-1	Matrix Fibroblasts
GGCAATTCAAGCCGTC-1	Matrix Fibroblasts
GGCAATTGTACAGTTC-1	Matrix Fibroblasts
TACCTTACACGGATAG-1	Matrix Fibroblasts
AAGGCAGTCAGAGCTT-1	Matrix Fibroblasts
AAATGCCAGAATAGGG-1	Matrix Fibroblasts
TAGGCATAGGAGTTGC-1	Matrix Fibroblasts
ATCACGAAGGCTAGAC-1	Matrix Fibroblasts
GGCCGATAGACGCTTT-1	Matrix Fibroblasts
CGAGCCAGTCCGACGT-1	Matrix Fibroblasts
AAAGATGGTCACTGGC-1	Matrix Fibroblasts
CACCAGGTCGTTTATC-1	Matrix Fibroblasts
TCATTACAGTCTCAAC-1	Matrix Fibroblasts
CTGGTCTAGTCGAGTG-1	Matrix Fibroblasts
CAGATCATCCGCTGTT-1	Matrix Fibroblasts
CACAAACTCTACTATC-1	Matrix Fibroblasts
CTCGTACCATGGTCTA-1	Matrix Fibroblasts
AGGGAGTCATCTCCCA-1	Matrix Fibroblasts
CGGCTAGCAGACAAAT-1	Matrix Fibroblasts
CCTATTACACACCGAC-1	Matrix Fibroblasts
CAACTAGAGATCGATA-1	Matrix Fibroblasts
GGTGTTACATGTTCCC-1	Matrix Fibroblasts
AGCCTAATCTGTTGAG-1	Matrix Fibroblasts
TACACGAAGCTGTCTA-1	Matrix Fibroblasts
GGCGTGTAGCGCCTCA-1	Matrix Fibroblasts
CACCTTGCATACTCTT-1	Matrix Fibroblasts
TTATGCTCAAAGTCAA-1	Matrix Fibroblasts
ACGCCAGGTATGAAAC-1	Matrix Fibroblasts
TGCGCAGAGACGACGT-1	Matrix Fibroblasts
CAGAATCAGCGCCTCA-1	Matrix Fibroblasts
GGACAAGAGCCCAACC-1	Matrix Fibroblasts
ATCTACTCATGCAACT-1	Matrix Fibroblasts
TCTTTCCTCCTGCAGG-1	Matrix Fibroblasts
TTGTAGGTCGCCAGCA-1	Matrix Fibroblasts
TCAGATGCATGCGCAC-1	Matrix Fibroblasts
TCGCGAGCATCCCATC-1	Matrix Fibroblasts
GTGTGCGGTAACGACG-1	Matrix Fibroblasts
ACGGAGAAGGCGTACA-1	Matrix Fibroblasts
GTAGTCAGTCCGTGAC-1	Matrix Fibroblasts
CACATAGTCATAACCG-1	Matrix Fibroblasts
CGGACACGTGACAAAT-1	Matrix Fibroblasts
ACGAGGACATCTCGCT-1	Matrix Fibroblasts
GTTTCTAAGCCGATTT-1	Matrix Fibroblasts
TGGTTAGCACGAAGCA-1	Matrix Fibroblasts
AGTTGGTCAGCTCGAC-1	Matrix Fibroblasts
GCATGTATCTACCAGA-1	Matrix Fibroblasts
CTGTTTAGTCATGCCG-1	Matrix Fibroblasts
TCAATCTAGGTAAACT-1	Matrix Fibroblasts
CGGCTAGAGGAGCGAG-1	Matrix Fibroblasts
ATGTGTGAGTTGTAGA-1	Matrix Fibroblasts
GCGCAACGTTGCGTTA-1	Matrix Fibroblasts
GACGTTACACGAAACG-1	Matrix Fibroblasts
GGCGTGTCACCCATGG-1	Matrix Fibroblasts
TCGGGACCACTGTCGG-1	Matrix Fibroblasts
AAACCTGCATTTGCTT-1	Matrix Fibroblasts
GCTGGGTAGACCTTTG-1	Matrix Fibroblasts
CGGAGCTCACTTACGA-1	Matrix Fibroblasts
GAAATGACATGCCACG-1	Matrix Fibroblasts
GCCAAATGTGCATCTA-1	Matrix Fibroblasts
CGGGTCATCCTCATTA-1	Matrix Fibroblasts
CGTAGCGTCCGCATCT-1	Matrix Fibroblasts
GTAACTGCAGGACCCT-1	Matrix Fibroblasts
TTCGAAGAGCAGCCTC-1	Matrix Fibroblasts
TGCTACCAGACGCAAC-1	Matrix Fibroblasts
ATTGGTGAGCGTGAGT-1	Matrix Fibroblasts
GATCGATGTGCAACTT-1	Matrix Fibroblasts
TCTTCGGCACTTCTGC-1	Matrix Fibroblasts
GGACGTCTCCTCATTA-1	Matrix Fibroblasts
CGTTAGACAGGATCGA-1	Matrix Fibroblasts
AGGTCCGGTACTCGCG-1	Matrix Fibroblasts
TAGACCATCCAAACAC-1	Matrix Fibroblasts
AGATTGCAGAGTTGGC-1	Matrix Fibroblasts
ATCCACCGTATAGGTA-1	Matrix Fibroblasts
TCGCGTTTCTTGTATC-1	Matrix Fibroblasts
ACGCCGATCAAGCCTA-1	Matrix Fibroblasts
AGCATACTCGCAGGCT-1	Matrix Fibroblasts
ACACCCTTCGTCACGG-1	Matrix Fibroblasts
CCGTTCATCCGCGCAA-1	Matrix Fibroblasts
GCAATCAAGATGTCGG-1	Matrix Fibroblasts
CATGCCTAGAGAGCTC-1	Matrix Fibroblasts
AGCCTAAGTAGAGTGC-1	Matrix Fibroblasts
TTGAACGTCCTATTCA-1	Matrix Fibroblasts
CGATGGCTCACGCATA-1	Matrix Fibroblasts
AGACGTTAGGGTTCCC-1	Matrix Fibroblasts
TATGCCCGTTATGTGC-1	Matrix Fibroblasts
GTGTGCGGTGTTCTTT-1	Matrix Fibroblasts
CCGGGATAGCACACAG-1	Matrix Fibroblasts
CTGAAACCACAGACTT-1	Matrix Fibroblasts
CGATTGATCTCCAACC-1	Matrix Fibroblasts
ACGTCAATCCATGCTC-1	Matrix Fibroblasts
AGGGTGAAGTCCTCCT-1	Matrix Fibroblasts
CACCACTTCAAACCAC-1	Matrix Fibroblasts
CAGGTGCGTGTCGCTG-1	Matrix Fibroblasts
CGGACACCATGGTAGG-1	Matrix Fibroblasts
TGCTACCCATATACCG-1	Matrix Fibroblasts
TTTGCGCGTTGCGTTA-1	Matrix Fibroblasts
GGAATAATCTTGCATT-1	Matrix Fibroblasts
ATTGGTGGTCATATCG-1	Matrix Fibroblasts
TGAGAGGCACCCTATC-1	Matrix Fibroblasts
AACACGTTCTGTCTCG-1	Matrix Fibroblasts
CTGATCCGTAGAAAGG-1	Matrix Fibroblasts
TTAACTCAGACAGACC-1	Matrix Fibroblasts
TAAGTGCCAACGATCT-1	Matrix Fibroblasts
ATAACGCAGACTGGGT-1	Matrix Fibroblasts
CTCTACGTCCGCGTTT-1	Matrix Fibroblasts
AGCGTCGAGGCGCTCT-1	Matrix Fibroblasts
CTACACCAGTAGGTGC-1	Matrix Fibroblasts
CGCGGTAAGCCATCGC-1	Matrix Fibroblasts
GTAGGCCCAAAGAATC-1	Matrix Fibroblasts
CGATGGCAGTCTCCTC-1	Matrix Fibroblasts
AGCCTAACATCCTAGA-1	Matrix Fibroblasts
CTGCCTAAGACTAGAT-1	Matrix Fibroblasts
CGTCTACCATCACAAC-1	Matrix Fibroblasts
CACATAGAGCGGCTTC-1	Matrix Fibroblasts
GACGGCTCACCCTATC-1	Matrix Fibroblasts
CGGACTGGTCGACTAT-1	Matrix Fibroblasts
ACGATACTCCCGACTT-1	Matrix Fibroblasts
AGTCTTTCAGGCAGTA-1	Matrix Fibroblasts
CTGCGGACACACAGAG-1	Matrix Fibroblasts
TCAGGTAAGGATGTAT-1	Matrix Fibroblasts
TCAGCAATCTCTGAGA-1	Matrix Fibroblasts
GTTAAGCAGCGGATCA-1	Matrix Fibroblasts
ACACCGGAGCGCCTTG-1	Matrix Fibroblasts
CGGCTAGCATGGATGG-1	Matrix Fibroblasts
ATCACGACAACACCTA-1	Matrix Fibroblasts
GGGCACTCAGTATCTG-1	Matrix Fibroblasts
CATCCACTCCATGCTC-1	Matrix Fibroblasts
AGATCTGTCTTACCGC-1	Matrix Fibroblasts
GGCCGATGTCACTTCC-1	Matrix Fibroblasts
ATCCGAAAGCGTGAGT-1	Matrix Fibroblasts
AACTTTCTCCGATATG-1	Matrix Fibroblasts
TCAATCTTCACGCATA-1	Matrix Fibroblasts
GTATCTTGTCGAGTTT-1	Matrix Fibroblasts
GAGCAGAAGGCCCTTG-1	Matrix Fibroblasts
TCATTTGCACCGCTAG-1	Matrix Fibroblasts
ACGATACGTCCAAGTT-1	Matrix Fibroblasts
GTAACGTCATAAAGGT-1	Matrix Fibroblasts
TCAGGTACATAGTAAG-1	Matrix Fibroblasts
TTCTACATCAGTGCAT-1	Matrix Fibroblasts
AAACGGGAGTGTTTGC-1	Matrix Fibroblasts
GTGCGGTAGCGATATA-1	Matrix Fibroblasts
CTGCCTAAGTAGGCCA-1	Matrix Fibroblasts
CCCATACTCACTTATC-1	Matrix Fibroblasts
TGTGTTTGTTGGTGGA-1	Matrix Fibroblasts
GATCTAGAGCACCGTC-1	Matrix Fibroblasts
TTGCCGTGTTCGTTGA-1	Matrix Fibroblasts
GTGTGCGCATGATCCA-1	Matrix Fibroblasts
CTAACTTTCTTGCCGT-1	Matrix Fibroblasts
GGGTCTGCACGGTAGA-1	Matrix Fibroblasts
CAAGTTGGTAGCCTCG-1	Matrix Fibroblasts
ATCCGAATCGGGAGTA-1	Matrix Fibroblasts
GCAAACTGTGCACTTA-1	Matrix Fibroblasts
GGAAAGCAGGGATGGG-1	Matrix Fibroblasts
CCTAAAGAGTGGCACA-1	Matrix Fibroblasts
CATCGGGAGAGCAATT-1	Matrix Fibroblasts
CTCGGAGAGTTATCGC-1	Matrix Fibroblasts
GTCACGGGTCCAGTTA-1	Matrix Fibroblasts
GACGTGCGTCCAAGTT-1	Matrix Fibroblasts
TCGGGACCATACTACG-1	Matrix Fibroblasts
AGTGAGGAGAGTCGGT-1	Matrix Fibroblasts
CCCATACTCTCTAGGA-1	Matrix Fibroblasts
ACGGGCTTCGGAAACG-1	Matrix Fibroblasts
CATGGCGAGGCAGTCA-1	Matrix Fibroblasts
AAACGGGGTGTATGGG-1	Matrix Fibroblasts
GCGCCAATCGCCTGTT-1	Matrix Fibroblasts
GGACATTGTCGGCATC-1	Matrix Fibroblasts
AGTGAGGCATAGACTC-1	Matrix Fibroblasts
CGGAGTCCAAGACGTG-1	Matrix Fibroblasts
GGGTCTGAGTGCCATT-1	Matrix Fibroblasts
GGGTTGCTCGCCGTGA-1	Matrix Fibroblasts
GAACATCGTTGTACAC-1	Matrix Fibroblasts
TCATTACTCACAAACC-1	Matrix Fibroblasts
CACAGTATCGACGGAA-1	Matrix Fibroblasts
GTCAAGTCAAGCTGAG-1	Matrix Fibroblasts
ATGAGGGCATACGCTA-1	Matrix Fibroblasts
TTCGGTCTCTCGCTTG-1	Matrix Fibroblasts
GCACATACACCAGGCT-1	Matrix Fibroblasts
AGCATACTCATGCATG-1	Matrix Fibroblasts
ACACCGGAGAAACGAG-1	Matrix Fibroblasts
GGAACTTAGCACAGGT-1	Matrix Fibroblasts
CACAAACTCGGCCGAT-1	Matrix Fibroblasts
GCTCCTATCCAGAAGG-1	Matrix Fibroblasts
CGCGGTATCATTATCC-1	Matrix Fibroblasts
AACTCAGTCTGCAAGT-1	Matrix Fibroblasts
CCTTTCTAGGTGTGGT-1	Matrix Fibroblasts
ACGATACTCCCAAGTA-1	Matrix Fibroblasts
TTAGTTCAGTGCAAGC-1	Matrix Fibroblasts
CTTAACTGTAGCTAAA-1	Matrix Fibroblasts
ATTGGACAGCGTCTAT-1	Matrix Fibroblasts
GTCCTCATCAGTCCCT-1	Matrix Fibroblasts
GCACTCTGTCGGATCC-1	Matrix Fibroblasts
GGCAATTCATCCAACA-1	Matrix Fibroblasts
TAGAGCTTCTTCGAGA-1	Matrix Fibroblasts
AAGCCGCCACTTCGAA-1	Matrix Fibroblasts
GATCAGTTCTCAACTT-1	Matrix Fibroblasts
TTTCCTCGTACCGCTG-1	Matrix Fibroblasts
CGGAGTCCAGCCACCA-1	Matrix Fibroblasts
CTACGTCGTTCCGTCT-1	Matrix Fibroblasts
GGACAAGTCAGCACAT-1	Matrix Fibroblasts
GTGCAGCGTGATGTGG-1	Matrix Fibroblasts
GGACAGATCCCATTTA-1	Matrix Fibroblasts
ACTGTCCTCGTCCAGG-1	Matrix Fibroblasts
TATTACCCACTTCGAA-1	Matrix Fibroblasts
TGTCCCACACTGTTAG-1	Matrix Fibroblasts
ACACTGACAGGCTCAC-1	Matrix Fibroblasts
AAACCTGGTAGAGGAA-1	Matrix Fibroblasts
GTGTGCGAGCGTCTAT-1	Matrix Fibroblasts
CATATTCAGTACGCCC-1	Matrix Fibroblasts
AGGGTGATCCCTTGCA-1	Matrix Fibroblasts
GGAAAGCGTAAAGTCA-1	Matrix Fibroblasts
AGCTTGACATCCAACA-1	Matrix Fibroblasts
TCTCATATCCTTTCTC-1	Matrix Fibroblasts
TACGGATTCCCGACTT-1	Matrix Fibroblasts
CACAGTATCAAACAAG-1	Matrix Fibroblasts
TCTCATATCATTATCC-1	Matrix Fibroblasts
AAAGCAAGTTGATTCG-1	Matrix Fibroblasts
AAGGAGCCATTTGCCC-1	Matrix Fibroblasts
AGACGTTAGAATTGTG-1	Matrix Fibroblasts
CATGGCGTCCAACCAA-1	Matrix Fibroblasts
ACGCAGCAGTATCGAA-1	Matrix Fibroblasts
TTTACTGCATGCCTTC-1	Matrix Fibroblasts
TCCACACAGTCGATAA-1	Matrix Fibroblasts
CGTCCATCATTGGCGC-1	Matrix Fibroblasts
GGCAATTTCTACTATC-1	Matrix Fibroblasts
TCGAGGCGTTGATTCG-1	Matrix Fibroblasts
CGTGTAAAGCTCCCAG-1	Matrix Fibroblasts
GTATCTTGTTATTCTC-1	Matrix Fibroblasts
TGCTACCTCATTGCCC-1	Matrix Fibroblasts
GCACATATCGCTTAGA-1	Matrix Fibroblasts
CAAGAAACATCACGAT-1	Matrix Fibroblasts
ATTGGACCATCGTCGG-1	Matrix Fibroblasts
AGATTGCCACCCTATC-1	Matrix Fibroblasts
GTTAAGCTCATGTGGT-1	Matrix Fibroblasts
TTTGGTTAGCTAGGCA-1	Matrix Fibroblasts
AAAGCAAAGAAACCGC-1	Matrix Fibroblasts
TCTTCGGAGGCAGTCA-1	Matrix Fibroblasts
TTCGAAGTCAGTTTGG-1	Matrix Fibroblasts
GACAGAGAGCCACCTG-1	Matrix Fibroblasts
TCTCTAAGTAATCACC-1	Matrix Fibroblasts
AAATGCCCATACGCTA-1	Matrix Fibroblasts
CGGAGTCGTCCGACGT-1	Matrix Fibroblasts
ACTGATGCAGCTCCGA-1	Matrix Fibroblasts
CCATGTCTCTAGAGTC-1	Matrix Fibroblasts
ATAACGCTCTGTCTAT-1	Matrix Fibroblasts
ACGTCAACAAAGCAAT-1	Matrix Fibroblasts
AGAGCTTGTACTTGAC-1	Matrix Fibroblasts
CTTGGCTAGTACACCT-1	Matrix Fibroblasts
AGAATAGCACGCTTTC-1	Matrix Fibroblasts
CATCCACGTGTTTGTG-1	Matrix Fibroblasts
CACACTCTCGCATGGC-1	Matrix Fibroblasts
TGAGCCGGTATTCTCT-1	Matrix Fibroblasts
GAAGCAGGTATGAATG-1	Matrix Fibroblasts
AACTGGTCACCTATCC-1	Matrix Fibroblasts
CTCAGAAAGACAAAGG-1	Matrix Fibroblasts
GTTAAGCGTGAGGCTA-1	Matrix Fibroblasts
CGTCCATCAGCGTTCG-1	Matrix Fibroblasts
GATGCTAAGTCACGCC-1	Matrix Fibroblasts
TGACGGCTCATCATTC-1	Matrix Fibroblasts
CTGGTCTAGCAGATCG-1	Matrix Fibroblasts
CGTTGGGAGGACTGGT-1	Matrix Fibroblasts
CTTGGCTAGTCGTACT-1	Matrix Fibroblasts
CGGAGCTCACAGAGGT-1	Matrix Fibroblasts
TATCAGGTCAAAGTAG-1	Matrix Fibroblasts
GCGAGAACACGGTAAG-1	Matrix Fibroblasts
CCTTTCTCACGAAAGC-1	Matrix Fibroblasts
TTTGCGCCATACAGCT-1	Matrix Fibroblasts
CGGACACGTATAAACG-1	Matrix Fibroblasts
AGAGCTTCATAGACTC-1	Matrix Fibroblasts
AGTGGGACACCTGGTG-1	Matrix Fibroblasts
AGCTCCTCAAGCGATG-1	Matrix Fibroblasts
TGAGCATTCGTTGCCT-1	Matrix Fibroblasts
ACTTTCAAGAAGGTTT-1	Matrix Fibroblasts
GGAACTTCAGGTCTCG-1	Matrix Fibroblasts
ATCATCTAGGCGCTCT-1	Matrix Fibroblasts
CTGTTTACACGACGAA-1	Matrix Fibroblasts
TCGAGGCCACCTTGTC-1	Matrix Fibroblasts
TGTATTCGTCATGCAT-1	Matrix Fibroblasts
GTCACAATCCCTGACT-1	Matrix Fibroblasts
AACTGGTTCATGTCTT-1	Matrix Fibroblasts
CGCTATCTCACATAGC-1	Matrix Fibroblasts
GGGACCTGTCCTCTTG-1	Matrix Fibroblasts
TTTATGCGTAAGTAGT-1	Matrix Fibroblasts
AAGGTTCTCGGATGGA-1	Matrix Fibroblasts
AGCTCTCCAAATTGCC-1	Matrix Fibroblasts
GTCGGGTAGAAACCGC-1	Matrix Fibroblasts
CTAACTTAGCACAGGT-1	Matrix Fibroblasts
CCGTACTGTCCGAATT-1	Matrix Fibroblasts
TAGTTGGCAAGACACG-1	Matrix Fibroblasts
CATCGGGGTCGAAAGC-1	Matrix Fibroblasts
GGGCACTTCCGCATCT-1	Matrix Fibroblasts
TAGTGGTGTCGGCTCA-1	Matrix Fibroblasts
CGATTGAGTTGCGCAC-1	Matrix Fibroblasts
GACCTGGCAATGGATA-1	Matrix Fibroblasts
AGTGAGGCAAACGCGA-1	Matrix Fibroblasts
TGGTTCCAGGCAATTA-1	Matrix Fibroblasts
CTCGTACAGGGTCTCC-1	Matrix Fibroblasts
CTCGGGAAGGAGTTTA-1	Matrix Fibroblasts
GTCAAGTCACCATGTA-1	Matrix Fibroblasts
TCGGGACAGAAGAAGC-1	Matrix Fibroblasts
TGGTTAGAGTGGGTTG-1	Matrix Fibroblasts
GACCAATAGCGACGTA-1	Matrix Fibroblasts
TACGGGCTCCAACCAA-1	Matrix Fibroblasts
CTTGGCTAGATGCCTT-1	Matrix Fibroblasts
TACCTATGTGCACTTA-1	Matrix Fibroblasts
TTGAACGTCGGCGGTT-1	Matrix Fibroblasts
ATGTGTGAGGGAACGG-1	Matrix Fibroblasts
GTGCATACACCATCCT-1	Matrix Fibroblasts
GACGCGTGTCTGGAGA-1	Matrix Fibroblasts
ACTTACTTCCCAACGG-1	Matrix Fibroblasts
GACACGCTCCTAGTGA-1	Matrix Fibroblasts
AGATCTGAGACCTTTG-1	Matrix Fibroblasts
TTAACTCGTACCAGTT-1	Matrix Fibroblasts
ACGATACGTATATGAG-1	Matrix Fibroblasts
TCAGCAACAGCTTAAC-1	Matrix Fibroblasts
CTACGTCTCAACGGCC-1	Matrix Fibroblasts
ACTGTCCAGCGTGAGT-1	Matrix Fibroblasts
AGCGTCGCACGAAAGC-1	Matrix Fibroblasts
TGCTGCTGTTGGTTTG-1	Matrix Fibroblasts
CTACATTCATCTCCCA-1	Matrix Fibroblasts
AGTAGTCAGTACGTAA-1	Matrix Fibroblasts
GGTATTGAGAGTACCG-1	Matrix Fibroblasts
TTTATGCGTGATGCCC-1	Matrix Fibroblasts
TCGGTAAGTAAGCACG-1	Matrix Fibroblasts
GTGCAGCCATTAACCG-1	Matrix Fibroblasts
ATGTGTGGTTGGAGGT-1	Matrix Fibroblasts
CTCGAGGAGGCTACGA-1	Matrix Fibroblasts
GTCACAAGTCTTCGTC-1	Matrix Fibroblasts
TTATGCTTCGGATGGA-1	Matrix Fibroblasts
TACTTGTGTGATAAAC-1	Matrix Fibroblasts
AGTAGTCTCACGAAGG-1	Matrix Fibroblasts
CCTTCCCTCTAGCACA-1	Matrix Fibroblasts
CATGCCTGTGACGCCT-1	Matrix Fibroblasts
AGCATACCAAAGGCGT-1	Matrix Fibroblasts
ACTGCTCAGTTGCAGG-1	Matrix Fibroblasts
TGGTTAGCACGAAATA-1	Matrix Fibroblasts
CATGGCGTCTCGTATT-1	Matrix Fibroblasts
GACCTGGTCCCAACGG-1	Matrix Fibroblasts
GTATCTTAGGCAAAGA-1	Matrix Fibroblasts
GTGTTAGGTGAGGCTA-1	Matrix Fibroblasts
GGAATAAGTTCAGGCC-1	Matrix Fibroblasts
CAAGATCAGCCACGCT-1	Matrix Fibroblasts
ACGGGTCGTTAAGACA-1	Matrix Fibroblasts
AGCTCCTAGGTTACCT-1	Matrix Fibroblasts
GAACATCAGTCAAGCG-1	Matrix Fibroblasts
GTACGTAGTGCAACTT-1	Matrix Fibroblasts
GACCTGGCATCGGACC-1	Matrix Fibroblasts
TGAGCCGAGGCGTACA-1	Matrix Fibroblasts
CTCTACGAGCACAGGT-1	Matrix Fibroblasts
ATGAGGGAGAAGGACA-1	Matrix Fibroblasts
TTAGTTCCAGCTGCAC-1	Matrix Fibroblasts
CCTTCCCAGCTAACAA-1	Matrix Fibroblasts
GCGACCAAGCACAGGT-1	Matrix Fibroblasts
CGATCGGGTCATACTG-1	Matrix Fibroblasts
AAAGTAGAGAGGACGG-1	Matrix Fibroblasts
TTGTAGGCACATGGGA-1	Matrix Fibroblasts
TAGGCATAGGTAGCCA-1	Matrix Fibroblasts
GACGTGCTCTACTATC-1	Matrix Fibroblasts
ATTCTACTCTACTCAT-1	Matrix Fibroblasts
ATCTGCCTCCTTGGTC-1	Matrix Fibroblasts
GCGCCAAGTAGCTCCG-1	Matrix Fibroblasts
GCGACCACAACTGCTA-1	Matrix Fibroblasts
GCAATCAAGCACCGTC-1	Matrix Fibroblasts
CATGGCGCACTGCCAG-1	Matrix Fibroblasts
GCGCAACCATTTCAGG-1	Matrix Fibroblasts
CGTCACTAGATCTGCT-1	Matrix Fibroblasts
TGAAAGAAGCGCTTAT-1	Matrix Fibroblasts
TTATGCTGTCCGAAGA-1	Matrix Fibroblasts
TTGGCAACAACGCACC-1	Matrix Fibroblasts
CATGACAGTGCACCAC-1	Matrix Fibroblasts
GTAGTCAAGTGAAGAG-1	Matrix Fibroblasts
TCGCGAGGTCTCCCTA-1	Matrix Fibroblasts
ACATACGTCGGACAAG-1	Matrix Fibroblasts
ACGTCAATCAACGAAA-1	Matrix Fibroblasts
CAACCAATCACCCGAG-1	Matrix Fibroblasts
GCGCAACAGCCAGTAG-1	Matrix Fibroblasts
GAAGCAGAGCTGCCCA-1	Matrix Fibroblasts
TTTACTGCACCGTTGG-1	Matrix Fibroblasts
TGGTTAGTCGCACTCT-1	Matrix Fibroblasts
CATATGGCACCACGTG-1	Matrix Fibroblasts
GACTGCGTCACTCTTA-1	Matrix Fibroblasts
TGGGAAGCAAGTAGTA-1	Matrix Fibroblasts
CGAACATTCCGAGCCA-1	Matrix Fibroblasts
TGCCCATGTGCGATAG-1	Matrix Fibroblasts
ATAACGCAGTCGCCGT-1	Matrix Fibroblasts
GTAGTCATCCACGACG-1	Matrix Fibroblasts
GCCTCTATCGAACGGA-1	Matrix Fibroblasts
AGACGTTAGAGTACCG-1	Matrix Fibroblasts
AGACGTTTCGCCGTGA-1	Matrix Fibroblasts
TACCTATGTGATAAAC-1	Matrix Fibroblasts
TATGCCCTCGTGGACC-1	Matrix Fibroblasts
GTTAAGCTCTCCCTGA-1	Matrix Fibroblasts
ATTGGACGTTGGAGGT-1	Matrix Fibroblasts
TAAGCGTCAGGACCCT-1	Matrix Fibroblasts
AAACCTGTCCCATTTA-1	Matrix Fibroblasts
GTGCAGCAGTGTACGG-1	Matrix Fibroblasts
TGCGTGGGTTGACGTT-1	Matrix Fibroblasts
CACAGTATCTGTTGAG-1	Matrix Fibroblasts
GATTCAGTCGTCGTTC-1	Matrix Fibroblasts
CACACAAAGGACCACA-1	Matrix Fibroblasts
TAAACCGCAACACGCC-1	Matrix Fibroblasts
ATCATGGGTATAGTAG-1	Matrix Fibroblasts
ACGATGTAGTGAAGAG-1	Matrix Fibroblasts
ACCAGTAGTAAGTTCC-1	Matrix Fibroblasts
TACGGATAGAGCAATT-1	Matrix Fibroblasts
AGAGTGGTCATAACCG-1	Matrix Fibroblasts
AAACGGGGTTACCAGT-1	Matrix Fibroblasts
CGTTAGATCGCAAGCC-1	Matrix Fibroblasts
TGGACGCTCTTGCATT-1	Matrix Fibroblasts
CCACGGATCTCGAGTA-1	Matrix Fibroblasts
GTACGTAAGCTACCGC-1	Matrix Fibroblasts
CTGTGCTAGCCGTCGT-1	Matrix Fibroblasts
TGTTCCGAGGAGTCTG-1	Matrix Fibroblasts
ATCCACCGTAATCGTC-1	Matrix Fibroblasts
TGCCAAAGTCGAATCT-1	Matrix Fibroblasts
CCTACACTCTTATCTG-1	Matrix Fibroblasts
CCTCTGATCGAACGGA-1	Matrix Fibroblasts
ACACCCTCAAGCTGTT-1	Matrix Fibroblasts
CCCAGTTTCCTAGGGC-1	Matrix Fibroblasts
GCATGATTCATGCTCC-1	Matrix Fibroblasts
AGACGTTTCTCGATGA-1	Matrix Fibroblasts
CTGCTGTCATTGCGGC-1	Matrix Fibroblasts
AGAATAGAGGAGTAGA-1	Matrix Fibroblasts
TAGGCATAGTGGGTTG-1	Matrix Fibroblasts
GAAACTCGTGGACGAT-1	Matrix Fibroblasts
TCAATCTAGCGATGAC-1	Matrix Fibroblasts
CTAGCCTAGGGAGTAA-1	Matrix Fibroblasts
TTCGGTCCATTGCGGC-1	Matrix Fibroblasts
CCGTTCAGTCCAGTTA-1	Matrix Fibroblasts
TAGACCAGTAGTACCT-1	Matrix Fibroblasts
AGTGAGGCAACGATGG-1	Matrix Fibroblasts
AAGTCTGCAATACGCT-1	Matrix Fibroblasts
TAGACCATCACTCTTA-1	Matrix Fibroblasts
CGATCGGGTTCCACTC-1	Matrix Fibroblasts
GATCGTATCGCCTGTT-1	Matrix Fibroblasts
CTGTTTAAGAAACCGC-1	Matrix Fibroblasts
GTTACAGGTAGATTAG-1	Matrix Fibroblasts
GATGAGGTCGGAGCAA-1	Matrix Fibroblasts
ATGTGTGGTATATGGA-1	Matrix Fibroblasts
CCTATTACAACTGCTA-1	Matrix Fibroblasts
CTCTGGTCAGTCAGCC-1	Matrix Fibroblasts
TCTCTAATCTTGAGAC-1	Matrix Fibroblasts
ATAGACCCATCGACGC-1	Matrix Fibroblasts
CAGATCACAAACCCAT-1	Matrix Fibroblasts
GTATCTTAGATAGGAG-1	Matrix Fibroblasts
CCTACCAAGGAACTGC-1	Matrix Fibroblasts
CGACCTTAGTACCGGA-1	Matrix Fibroblasts
TTTGTCAGTCTTCGTC-1	Matrix Fibroblasts
CAGTCCTGTTCAGACT-1	Matrix Fibroblasts
GGCCGATTCTTAACCT-1	Matrix Fibroblasts
AACGTTGAGCTGCGAA-1	Matrix Fibroblasts
TGTGTTTGTTCAACCA-1	Matrix Fibroblasts
GACCAATAGACAATAC-1	Matrix Fibroblasts
GAAACTCGTTACGGAG-1	Matrix Fibroblasts
TGCGGGTGTTTGCATG-1	Matrix Fibroblasts
TGCCCTAGTTTAAGCC-1	Matrix Fibroblasts
GCTGCAGAGGGTGTTG-1	Matrix Fibroblasts
GAAATGATCCTGCCAT-1	Matrix Fibroblasts
CTGGTCTCATGTTCCC-1	Matrix Fibroblasts
GATCAGTTCCGCATAA-1	Matrix Fibroblasts
ACTGCTCTCCTAAGTG-1	Matrix Fibroblasts
GCGACCAGTGCGAAAC-1	Matrix Fibroblasts
AGGTCATTCTGGGCCA-1	Matrix Fibroblasts
TTGTAGGCAGATAATG-1	Matrix Fibroblasts
GCTCCTAGTCCTCTTG-1	Matrix Fibroblasts
CGATTGAGTAGCTTGT-1	Matrix Fibroblasts
TTTCCTCGTCCTCTTG-1	Matrix Fibroblasts
CGGACACAGTAGTGCG-1	Matrix Fibroblasts
TACCTTATCAGTCCCT-1	Matrix Fibroblasts
ATCACGAGTGGTACAG-1	Matrix Fibroblasts
AAGGTTCTCTATGTGG-1	Matrix Fibroblasts
CATCCACTCTTGCCGT-1	Matrix Fibroblasts
TACCTATTCATATCGG-1	Matrix Fibroblasts
GAAACTCGTGGTGTAG-1	Matrix Fibroblasts
CTCTGGTAGTCAATAG-1	Matrix Fibroblasts
CACACAAAGCTGCCCA-1	Matrix Fibroblasts
GCTTCCAGTATATCCG-1	Matrix Fibroblasts
TGCGGGTTCTGAGGGA-1	Matrix Fibroblasts
CTGATCCAGGTGTGGT-1	Matrix Fibroblasts
CCAATCCGTGAAAGAG-1	Matrix Fibroblasts
CTGCTGTTCCACTCCA-1	Matrix Fibroblasts
AGTCTTTGTCTTCAAG-1	Matrix Fibroblasts
TCAACGAGTACGACCC-1	Matrix Fibroblasts
GAACGGAAGTGGAGTC-1	Matrix Fibroblasts
ACCGTAAGTTGATTGC-1	Matrix Fibroblasts
GATCTAGCAGTGGGAT-1	Matrix Fibroblasts
TACAGTGTCACTCCTG-1	Matrix Fibroblasts
AAGACCTGTACGCACC-1	Matrix Fibroblasts
CTGGTCTTCCTTTCTC-1	Matrix Fibroblasts
GCTCCTAAGGGAACGG-1	Matrix Fibroblasts
TACCTTAAGTACCGGA-1	Matrix Fibroblasts
ATCACGAGTCGTGGCT-1	Matrix Fibroblasts
CATCGGGGTACAAGTA-1	Matrix Fibroblasts
AAGTCTGAGCGCCTTG-1	Matrix Fibroblasts
CTCGTACGTGATGTCT-1	Matrix Fibroblasts
CCGTTCAAGGAGTCTG-1	Matrix Fibroblasts
GACAGAGAGATATGCA-1	Matrix Fibroblasts
AGAGCTTGTAAGAGAG-1	Matrix Fibroblasts
CTTGGCTAGCTTATCG-1	Matrix Fibroblasts
GATCTAGAGTGGGCTA-1	Matrix Fibroblasts
CGTTAGATCCGTAGGC-1	Matrix Fibroblasts
CTAACTTAGGGATCTG-1	Matrix Fibroblasts
CACCTTGTCTCTAAGG-1	Matrix Fibroblasts
GGCGTGTTCGTAGGTT-1	Matrix Fibroblasts
GACACGCTCATTCACT-1	Matrix Fibroblasts
CCCAATCAGAGTACAT-1	Matrix Fibroblasts
ACGGGTCCAGATGGCA-1	Matrix Fibroblasts
GCATGCGTCCAGTAGT-1	Matrix Fibroblasts
ACTTACTAGGAGTAGA-1	Matrix Fibroblasts
CTGTTTACAGTGAGTG-1	Matrix Fibroblasts
TTCTCAAGTCCTGCTT-1	Matrix Fibroblasts
CCCAGTTCAATAGAGT-1	Matrix Fibroblasts
CGGTTAAAGCTAGCCC-1	Matrix Fibroblasts
CGGACACCAAGGACAC-1	Matrix Fibroblasts
ATCCGAAAGATCGGGT-1	Matrix Fibroblasts
GGCTCGACACGAAATA-1	Matrix Fibroblasts
CCAGCGAAGACACGAC-1	Matrix Fibroblasts
ACGGGTCGTACTTAGC-1	Matrix Fibroblasts
GCTTCCATCAGTACGT-1	Matrix Fibroblasts
GCATGTATCCAGAAGG-1	Matrix Fibroblasts
CACACTCCAGATCTGT-1	Matrix Fibroblasts
GTAACTGGTGGCAAAC-1	Matrix Fibroblasts
GTCCTCATCCGCGGTA-1	Matrix Fibroblasts
CAGAGAGAGCTTTGGT-1	Matrix Fibroblasts
GTAACTGCAGGAATGC-1	Matrix Fibroblasts
CTCGGAGAGCTTTGGT-1	Matrix Fibroblasts
TGCACCTAGACATAAC-1	Matrix Fibroblasts
ATCATGGTCTGCGGCA-1	Matrix Fibroblasts
CGATGTAAGCAAATCA-1	Matrix Fibroblasts
GCGAGAATCTTGCAAG-1	Matrix Fibroblasts
CTCGTCAAGCACACAG-1	Matrix Fibroblasts
TTCGGTCGTTTAGGAA-1	Matrix Fibroblasts
AGCGGTCGTGTGTGCC-1	Matrix Fibroblasts
CTCCTAGAGTTGAGTA-1	Matrix Fibroblasts
AGTGGGAAGATCCCGC-1	Matrix Fibroblasts
CGTAGGCTCCTTTACA-1	Matrix Fibroblasts
GCGGGTTTCGCGCCAA-1	Matrix Fibroblasts
CTGCGGAGTGATAAAC-1	Matrix Fibroblasts
GCCAAATTCGCCTGTT-1	Matrix Fibroblasts
AAGTCTGGTCGATTGT-1	Matrix Fibroblasts
ATTACTCCATCGGACC-1	Matrix Fibroblasts
ATCTGCCCATGCTAGT-1	Matrix Fibroblasts
GGCGACTTCAACGAAA-1	Matrix Fibroblasts
CACCACTAGGCTAGAC-1	Matrix Fibroblasts
TGACTAGGTCTCTCTG-1	Matrix Fibroblasts
AAACGGGGTACCAGTT-1	Matrix Fibroblasts
TTCTCAACACAACTGT-1	Matrix Fibroblasts
AGTGTCAAGGACAGCT-1	Matrix Fibroblasts
TCGAGGCTCAGCCTAA-1	Matrix Fibroblasts
GCGAGAAAGAACAACT-1	Matrix Fibroblasts
TCACGAACACATCTTT-1	Matrix Fibroblasts
CCTTCCCAGGCTAGGT-1	Matrix Fibroblasts
TCAATCTAGTTTCCTT-1	Matrix Fibroblasts
CCACCTACACCACGTG-1	Matrix Fibroblasts
CTTTGCGAGACGCACA-1	Matrix Fibroblasts
GTGCGGTCATCGGGTC-1	Matrix Fibroblasts
CCGTGGAGTGTTTGGT-1	Matrix Fibroblasts
TCGTAGAGTGTGCCTG-1	Matrix Fibroblasts
GGACAAGCACCAGTTA-1	Matrix Fibroblasts
GAACGGAGTGACTCAT-1	Matrix Fibroblasts
TTTATGCCATGCTGGC-1	Matrix Fibroblasts
TGTATTCAGTGGTCCC-1	Matrix Fibroblasts
TTTCCTCAGCTGCCCA-1	Matrix Fibroblasts
ACATCAGAGTCCGGTC-1	Matrix Fibroblasts
GAGGTGAGTCCGTGAC-1	Matrix Fibroblasts
GGACAAGGTATGAAAC-1	Matrix Fibroblasts
GATCGCGGTTATGCGT-1	Matrix Fibroblasts
TAGACCAAGCGTGAGT-1	Matrix Fibroblasts
ACCGTAACAAATTGCC-1	Matrix Fibroblasts
GGACAAGAGGACCACA-1	Matrix Fibroblasts
TCGTACCTCCGATATG-1	Matrix Fibroblasts
ATTATCCCAGCAGTTT-1	Matrix Fibroblasts
TACGGGCCATGCCTTC-1	Matrix Fibroblasts
CCACGGAGTCTCCATC-1	Matrix Fibroblasts
ACTGTCCCAATCGAAA-1	Matrix Fibroblasts
CTGGTCTAGCGAGAAA-1	Matrix Fibroblasts
AAAGATGTCTCCCTGA-1	Matrix Fibroblasts
TCCCGATTCACCCTCA-1	Matrix Fibroblasts
ATCGAGTAGGAATGGA-1	Matrix Fibroblasts
GTGTTAGGTATAAACG-1	Matrix Fibroblasts
TACCTTATCAGAGGTG-1	Matrix Fibroblasts
CTTCTCTCACAGGAGT-1	Matrix Fibroblasts
GCTGCGAGTTTAGCTG-1	Matrix Fibroblasts
TACTTGTAGATGCCTT-1	Matrix Fibroblasts
GGTGAAGTCGCTTGTC-1	Matrix Fibroblasts
TTAGGACTCAAGGCTT-1	Matrix Fibroblasts
GTTTCTATCCCACTTG-1	Matrix Fibroblasts
ACGCCAGGTTTGCATG-1	Matrix Fibroblasts
CGTGTCTTCGATCCCT-1	Matrix Fibroblasts
GATTCAGGTGTGGTTT-1	Matrix Fibroblasts
TACTTACTCCACGCAG-1	Matrix Fibroblasts
AGTCTTTTCATCGCTC-1	Matrix Fibroblasts
ACACCGGGTACAGTTC-1	Matrix Fibroblasts
GATCGATAGTCCATAC-1	Matrix Fibroblasts
CGTTCTGAGCCATCGC-1	Matrix Fibroblasts
GCATGTACAAAGAATC-1	Matrix Fibroblasts
AACGTTGCAGCTGTGC-1	Matrix Fibroblasts
CACACCTAGACCTTTG-1	Matrix Fibroblasts
GAATGAAGTCAGAATA-1	Matrix Fibroblasts
TTTACTGGTCAGCTAT-1	Matrix Fibroblasts
GTATTCTTCGTGGACC-1	Matrix Fibroblasts
AGAGTGGAGCACACAG-1	Matrix Fibroblasts
CTTTGCGGTTAGGGTG-1	Matrix Fibroblasts
CGGCTAGAGGAGTTGC-1	Matrix Fibroblasts
TTTGCGCCACAAGTAA-1	Matrix Fibroblasts
TATCAGGAGGTGCTAG-1	Matrix Fibroblasts
AGGTCATGTTTACTCT-1	Matrix Fibroblasts
ATAGACCAGCGGCTTC-1	Matrix Fibroblasts
GTAGGCCGTCTCTCGT-1	Matrix Fibroblasts
AGCCTAAAGAACAACT-1	Matrix Fibroblasts
CGCTGGATCTGTTGAG-1	Matrix Fibroblasts
TGACGGCCATCCGTGG-1	Matrix Fibroblasts
GACCTGGAGTAGTGCG-1	Matrix Fibroblasts
CCAATCCGTTCTGTTT-1	Matrix Fibroblasts
ACGCAGCAGACTTTCG-1	Matrix Fibroblasts
GTCTCGTTCAGCGACC-1	Matrix Fibroblasts
ACGCAGCGTCTGCAAT-1	Matrix Fibroblasts
GTAACTGTCGTACCGG-1	Matrix Fibroblasts
GCGAGAAGTCGAGTTT-1	Matrix Fibroblasts
TCGAGGCCAGTCAGCC-1	Matrix Fibroblasts
GCGCCAACACCTATCC-1	Matrix Fibroblasts
CCTAGCTTCGCGTAGC-1	Matrix Fibroblasts
TGAGGGAGTCCGAACC-1	Matrix Fibroblasts
GTCACGGCACTGCCAG-1	Matrix Fibroblasts
TGCACCTCAATAGCAA-1	Matrix Fibroblasts
CTTAGGAAGTCACGCC-1	Matrix Fibroblasts
ATTACTCCAGTACACT-1	Matrix Fibroblasts
CCAATCCAGCTCCTCT-1	Matrix Fibroblasts
TACTCATGTCCAAGTT-1	Matrix Fibroblasts
TGTGGTACATGAGCGA-1	Matrix Fibroblasts
ATCTACTAGTCCAGGA-1	Matrix Fibroblasts
GTGTTAGGTTCCTCCA-1	Matrix Fibroblasts
CAGCATAGTAATCGTC-1	Matrix Fibroblasts
CTACATTCAAACGTGG-1	Matrix Fibroblasts
GTAACGTGTTCAGTAC-1	Matrix Fibroblasts
ATGGGAGAGCCAGAAC-1	Matrix Fibroblasts
AAGGTTCTCCTTGGTC-1	Matrix Fibroblasts
CGTCACTCAACGATCT-1	Matrix Fibroblasts
GCGCCAAGTCACCCAG-1	Matrix Fibroblasts
GCACATAAGGTGATTA-1	Matrix Fibroblasts
TCAGATGCACGGCGTT-1	Matrix Fibroblasts
TGCGCAGTCTCGCATC-1	Matrix Fibroblasts
ACGGAGACACGGACAA-1	Matrix Fibroblasts
AACCATGGTACTTGAC-1	Matrix Fibroblasts
GTGTGCGAGCTGCCCA-1	Matrix Fibroblasts
CAGCATATCAGGCAAG-1	Matrix Fibroblasts
GTCGGGTGTCTCAACA-1	Matrix Fibroblasts
CCCATACTCTGCTGCT-1	Matrix Fibroblasts
ACCTTTAGTCTAGAGG-1	Matrix Fibroblasts
TCGTACCGTACCGTAT-1	Matrix Fibroblasts
TTTGCGCTCAACCAAC-1	Matrix Fibroblasts
GACGCGTAGATCGATA-1	Matrix Fibroblasts
GACCTGGCATGACGGA-1	Matrix Fibroblasts
TCGAGGCTCCCTAACC-1	Matrix Fibroblasts
GCGGGTTGTAAGCACG-1	Matrix Fibroblasts
CGTAGGCCAGTCGTGC-1	Matrix Fibroblasts
ACGATACCAATCGAAA-1	Matrix Fibroblasts
CAGCAGCCATATACCG-1	Matrix Fibroblasts
TTCTTAGCAATCAGAA-1	Matrix Fibroblasts
AGCAGCCGTTTCCACC-1	Matrix Fibroblasts
CGGACGTGTCACTGGC-1	Matrix Fibroblasts
TCTCTAAAGATGCGAC-1	Matrix Fibroblasts
CGACTTCGTTGGACCC-1	Matrix Fibroblasts
GATCGTAAGTACGTTC-1	Matrix Fibroblasts
GAGGTGATCGAATGGG-1	Matrix Fibroblasts
GGTATTGCACTGTGTA-1	Matrix Fibroblasts
CAACTAGTCTCAACTT-1	Matrix Fibroblasts
AGGGTGATCAGCTCTC-1	Matrix Fibroblasts
ACTGATGTCCAACCAA-1	Matrix Fibroblasts
AACGTTGCACCGAAAG-1	Matrix Fibroblasts
TCTCTAAAGTTCGCAT-1	Matrix Fibroblasts
ACTTACTGTATATCCG-1	Matrix Fibroblasts
TGCCCTACACCATGTA-1	Matrix Fibroblasts
TATCAGGGTGTGCCTG-1	Matrix Fibroblasts
TGCCCTACAGTAACGG-1	Matrix Fibroblasts
GACGTTACACACCGCA-1	Matrix Fibroblasts
ACCCACTAGAATCTCC-1	Matrix Fibroblasts
GTCACAAGTCGCCATG-1	Matrix Fibroblasts
ATCCGAAAGTAGGCCA-1	Matrix Fibroblasts
AGGGAGTTCTATGTGG-1	Matrix Fibroblasts
TTGAACGCACATTTCT-1	Matrix Fibroblasts
GAAGCAGTCAGCAACT-1	Matrix Fibroblasts
GGTGCGTGTGCAGACA-1	Matrix Fibroblasts
CAGCTAAGTGCTCTTC-1	Matrix Fibroblasts
ACTGATGCATCCCACT-1	Matrix Fibroblasts
TTGCCGTAGACCGGAT-1	Matrix Fibroblasts
CCCATACCACTGTCGG-1	Matrix Fibroblasts
ACGTCAATCTGCGGCA-1	Matrix Fibroblasts
CAAGTTGGTACCGAGA-1	Matrix Fibroblasts
GGCAATTAGCGATTCT-1	Matrix Fibroblasts
CGTGTAAAGAGTACAT-1	Matrix Fibroblasts
CATCCACGTAACGACG-1	Matrix Fibroblasts
CAGATCACATTAACCG-1	Matrix Fibroblasts
TTGGCAAGTATATCCG-1	Matrix Fibroblasts
CCTATTACATGTCCTC-1	Matrix Fibroblasts
CGCGTTTGTGAGGGTT-1	Matrix Fibroblasts
CTACATTCAAAGGAAG-1	Matrix Fibroblasts
TGACTAGAGTGAAGAG-1	Matrix Fibroblasts
TGAGCCGTCCTATTCA-1	Matrix Fibroblasts
CGAGCACGTCTCTCTG-1	Matrix Fibroblasts
ATCGAGTTCCGTAGGC-1	Matrix Fibroblasts
CACAAACGTGGCCCTA-1	Matrix Fibroblasts
AGCTTGAAGGGCTCTC-1	Matrix Fibroblasts
CACACAACAGTAGAGC-1	Matrix Fibroblasts
TCATTTGAGAGCTGGT-1	Matrix Fibroblasts
ATCCGAAGTGTCCTCT-1	Matrix Fibroblasts
GGGAGATTCTTGTCAT-1	Matrix Fibroblasts
AGGTCCGAGAACAACT-1	Matrix Fibroblasts
AACTCCCCAGCGATCC-1	Matrix Fibroblasts
TAAGCGTAGAAAGTGG-1	Matrix Fibroblasts
AAAGCAATCGTTGACA-1	Matrix Fibroblasts
AAATGCCAGCGTCAAG-1	Matrix Fibroblasts
CTTCTCTAGCCACGCT-1	Matrix Fibroblasts
CACATTTGTTCTCATT-1	Matrix Fibroblasts
TGGGAAGGTCATATCG-1	Matrix Fibroblasts
CCACGGATCTAACTTC-1	Matrix Fibroblasts
GCTTCCACACAAGACG-1	Matrix Fibroblasts
GGGATGAAGGACACCA-1	Matrix Fibroblasts
TGCTGCTCATAGGATA-1	Matrix Fibroblasts
TGCGCAGTCAGTTCGA-1	Matrix Fibroblasts
CCACCTAGTCATATCG-1	Matrix Fibroblasts
CGCTGGACAATTGCTG-1	Matrix Fibroblasts
CACAGGCTCTCAACTT-1	Matrix Fibroblasts
CAGATCACACACATGT-1	Matrix Fibroblasts
CCTAAAGGTCCAAGTT-1	Matrix Fibroblasts
TTCGGTCGTCATTAGC-1	Matrix Fibroblasts
GGACATTCACGTAAGG-1	Matrix Fibroblasts
TCAATCTGTTCGCTAA-1	Matrix Fibroblasts
CCTTCCCCAGCAGTTT-1	Matrix Fibroblasts
GCTGGGTTCATACGGT-1	Matrix Fibroblasts
TTAACTCGTTCCCTTG-1	Matrix Fibroblasts
CAACCAACATACAGCT-1	Matrix Fibroblasts
CACACTCCACCAGCAC-1	Matrix Fibroblasts
GCGACCAAGCTATGCT-1	Matrix Fibroblasts
CCGTACTAGAGACTAT-1	Matrix Fibroblasts
ATAAGAGCAAAGGTGC-1	Matrix Fibroblasts
GACTACAGTCCGAAGA-1	Matrix Fibroblasts
GGACAGATCTCCGGTT-1	Matrix Fibroblasts
CCGGTAGCAAACCTAC-1	Matrix Fibroblasts
TGAGAGGAGCTAACAA-1	Matrix Fibroblasts
TTCGAAGGTCGTTGTA-1	Matrix Fibroblasts
GTTCGGGGTTACTGAC-1	Matrix Fibroblasts
ACGCCAGAGAGCTTCT-1	Matrix Fibroblasts
GGAAAGCTCATTATCC-1	Matrix Fibroblasts
AGCATACGTCTAGGTT-1	Matrix Fibroblasts
TTCTACATCTTGTACT-1	Matrix Fibroblasts
TTGACTTAGAGGGATA-1	Matrix Fibroblasts
GTCACAAAGCACGCCT-1	Matrix Fibroblasts
CATCAGAGTTTCCACC-1	Matrix Fibroblasts
TGAGCATCATCATCCC-1	Matrix Fibroblasts
TACGGGCCACAACTGT-1	Matrix Fibroblasts
ACCAGTAGTCTCCACT-1	Matrix Fibroblasts
CCGTACTTCCCATTTA-1	Matrix Fibroblasts
TTATGCTAGTGCGATG-1	Matrix Fibroblasts
CAAGTTGAGCCAGGAT-1	Matrix Fibroblasts
CGTTCTGAGTCAATAG-1	Matrix Fibroblasts
AGCAGCCGTCACCTAA-1	Matrix Fibroblasts
ATTCTACGTGTTCGAT-1	Matrix Fibroblasts
GTGAAGGGTTGTGGAG-1	Matrix Fibroblasts
CTACACCCATTCACTT-1	Matrix Fibroblasts
GTACTCCCAATCCGAT-1	Matrix Fibroblasts
TCTATTGGTGTTTGTG-1	Matrix Fibroblasts
ATTCTACAGTACGCCC-1	Matrix Fibroblasts
AACGTTGTCTTTAGGG-1	Matrix Fibroblasts
ACTATCTAGTGCGTGA-1	Matrix Fibroblasts
GTGCTTCCACATCCAA-1	Matrix Fibroblasts
GGCGTGTGTAGCGTAG-1	Matrix Fibroblasts
CGTGTAAGTCAGAGGT-1	Matrix Fibroblasts
ACCCACTGTCGCTTCT-1	Matrix Fibroblasts
TGACTAGGTCAGATAA-1	Matrix Fibroblasts
GGATTACGTCGAAAGC-1	Matrix Fibroblasts
CGTGTCTTCTCGTATT-1	Matrix Fibroblasts
CTCGGGAGTTATGCGT-1	Matrix Fibroblasts
ACAGCTACACAGCCCA-1	Matrix Fibroblasts
GGACGTCAGACAGGCT-1	Matrix Fibroblasts
TCTTTCCGTATAATGG-1	Matrix Fibroblasts
CACAGTAAGGCTAGAC-1	Matrix Fibroblasts
CGGTTAATCAGGTAAA-1	Matrix Fibroblasts
GCTGCAGAGACTCGGA-1	Matrix Fibroblasts
TACTTACTCTCCCTGA-1	Matrix Fibroblasts
GGGACCTGTCTGCAAT-1	Matrix Fibroblasts
TTATGCTTCCGTTGTC-1	Matrix Fibroblasts
TCATTACAGGAATGGA-1	Matrix Fibroblasts
CGTTAGACAGGTGCCT-1	Matrix Fibroblasts
TTATGCTAGTGCGTGA-1	Matrix Fibroblasts
TACGGGCGTTCCCGAG-1	Matrix Fibroblasts
AAGGTTCCATATGCTG-1	Matrix Fibroblasts
TCACGAAGTCTGGAGA-1	Matrix Fibroblasts
ACGATGTTCTTCTGGC-1	Matrix Fibroblasts
TTTGGTTCACAAGACG-1	Matrix Fibroblasts
TACTCATTCCCAAGAT-1	Matrix Fibroblasts
GATGCTACACTCGACG-1	Matrix Fibroblasts
GGGTTGCGTCCAAGTT-1	Matrix Fibroblasts
TGCGGGTAGCTAAGAT-1	Matrix Fibroblasts
ATTACTCGTAAACACA-1	Matrix Fibroblasts
CGGAGTCTCAGAGCTT-1	Matrix Fibroblasts
CTCGAAACAAGCTGAG-1	Matrix Fibroblasts
CACAGTAGTTATTCTC-1	Matrix Fibroblasts
GCGCCAACATCGGTTA-1	Matrix Fibroblasts
CTCATTAGTTAAGAAC-1	Matrix Fibroblasts
TCAGCTCAGATGTAAC-1	Matrix Fibroblasts
AGGGAGTGTCTCTCTG-1	Matrix Fibroblasts
AGCAGCCTCGGATGTT-1	Matrix Fibroblasts
AGAGCGACAGCTGTAT-1	Matrix Fibroblasts
ACATACGTCCCAAGAT-1	Matrix Fibroblasts
ACGCCGAAGGCGATAC-1	Matrix Fibroblasts
GACGTGCCATAGACTC-1	Matrix Fibroblasts
TTTACTGTCGCATGAT-1	Matrix Fibroblasts
CATATTCAGTTAACGA-1	Matrix Fibroblasts
GACTACATCCCAACGG-1	Matrix Fibroblasts
GAATGAATCGTCTGCT-1	Matrix Fibroblasts
GTGCGGTTCGCAGGCT-1	Matrix Fibroblasts
ACATACGTCTAGCACA-1	Matrix Fibroblasts
CATGACATCATGTGGT-1	Matrix Fibroblasts
TAGTTGGGTCTCAACA-1	Matrix Fibroblasts
GGTGTTACAGACAGGT-1	Matrix Fibroblasts
CGATGTACAGATGAGC-1	Matrix Fibroblasts
ACCCACTTCGTGGACC-1	Matrix Fibroblasts
CATCGGGGTAGTAGTA-1	Matrix Fibroblasts
GTAGGCCGTCTAGCCG-1	Matrix Fibroblasts
AAGCCGCGTAGCCTCG-1	Matrix Fibroblasts
CGTTGGGCATGCCTTC-1	Matrix Fibroblasts
GTTCTCGTCGTACGGC-1	Matrix Fibroblasts
GATCTAGCAGACACTT-1	Matrix Fibroblasts
CCGTACTGTTCCGGCA-1	Matrix Fibroblasts
ACGGGCTTCGGTCTAA-1	Matrix Fibroblasts
TGGACGCTCGTCGTTC-1	Matrix Fibroblasts
GTCTCGTCAGCTCGAC-1	Matrix Fibroblasts
ACTGCTCTCTCTGAGA-1	Matrix Fibroblasts
CTGCCTACAGATGAGC-1	Matrix Fibroblasts
AAGGCAGCAATAGAGT-1	Matrix Fibroblasts
CGTTGGGCATGGTCAT-1	Matrix Fibroblasts
CATCGAAGTTGAGGTG-1	Matrix Fibroblasts
TGGCCAGGTCGAGTTT-1	Matrix Fibroblasts
TGTGTTTCAAACTGCT-1	Matrix Fibroblasts
GGAACTTCACTGTGTA-1	Matrix Fibroblasts
ACTGTCCAGTCAAGGC-1	Matrix Fibroblasts
TTTGTCATCGTATCAG-1	Matrix Fibroblasts
GTTCTCGGTCTAGAGG-1	Matrix Fibroblasts
GGGATGAGTTCTGGTA-1	Matrix Fibroblasts
TGGTTAGAGCTAGTCT-1	Matrix Fibroblasts
AGAGTGGGTATCGCAT-1	Matrix Fibroblasts
AGCTTGACAAACCTAC-1	Matrix Fibroblasts
CATCGGGGTCACAAGG-1	Matrix Fibroblasts
TCGAGGCCACATGACT-1	Matrix Fibroblasts
GATGAAAAGTCATCCA-1	Matrix Fibroblasts
CCTACACAGCTGTTCA-1	Matrix Fibroblasts
ATCCACCTCTCGCATC-1	Matrix Fibroblasts
TGCTACCCATATGCTG-1	Matrix Fibroblasts
CTCTAATTCGAATGGG-1	Matrix Fibroblasts
GTATCTTGTCGAACAG-1	Matrix Fibroblasts
TCATTACTCGTACGGC-1	Matrix Fibroblasts
AAACGGGCAAATCCGT-1	Matrix Fibroblasts
TACTTACCAGGATCGA-1	Matrix Fibroblasts
ACTTACTGTATATGGA-1	Matrix Fibroblasts
CCGTTCAGTATAGTAG-1	Matrix Fibroblasts
CGAACATAGAACAACT-1	Matrix Fibroblasts
AATCCAGCACATTAGC-1	Matrix Fibroblasts
CTGCGGATCCCTCTTT-1	Matrix Fibroblasts
TTTGCGCGTCACCTAA-1	Matrix Fibroblasts
CAAGATCGTCTGATTG-1	Matrix Fibroblasts
GACGTTAAGTACGCCC-1	Matrix Fibroblasts
AGCTCCTGTTTCCACC-1	Matrix Fibroblasts
CTGTTTACAAGTTGTC-1	Matrix Fibroblasts
TCTGGAATCTAAGCCA-1	Matrix Fibroblasts
CACCTTGAGCGCTCCA-1	Matrix Fibroblasts
CGGTTAAAGCAACGGT-1	Matrix Fibroblasts
ACTGCTCTCGGTTCGG-1	Matrix Fibroblasts
GTGTGCGTCCGCGGTA-1	Matrix Fibroblasts
CGTAGCGCAGGGCATA-1	Matrix Fibroblasts
GAATGAAAGAACAATC-1	Matrix Fibroblasts
AACTCTTCATCTGGTA-1	Matrix Fibroblasts
TCTTCGGTCGTCCAGG-1	Matrix Fibroblasts
GGGAATGCAAGTTAAG-1	Matrix Fibroblasts
ATCATGGCAGTATCTG-1	Matrix Fibroblasts
CATTATCGTCCGTCAG-1	Matrix Fibroblasts
GACCAATCACATGTGT-1	Matrix Fibroblasts
CTGTGCTCATATACCG-1	Matrix Fibroblasts
CAGTAACCACAGGCCT-1	Matrix Fibroblasts
GGGTCTGGTTCCGGCA-1	Matrix Fibroblasts
GACCAATTCTCCCTGA-1	Matrix Fibroblasts
TCAGATGAGCTCTCGG-1	Matrix Fibroblasts
CGGCTAGAGGATATAC-1	Matrix Fibroblasts
GTAACTGTCGGTCCGA-1	Matrix Fibroblasts
CTGTTTATCAAGCCTA-1	Matrix Fibroblasts
CACACCTTCGCCAAAT-1	Matrix Fibroblasts
GCTGCTTAGTCACGCC-1	Matrix Fibroblasts
GGTGCGTGTCCAAGTT-1	Matrix Fibroblasts
AGCGTCGCAGGGTATG-1	Matrix Fibroblasts
ATTTCTGGTGACTACT-1	Matrix Fibroblasts
GTCTTCGGTTCATGGT-1	Matrix Fibroblasts
GCATACATCGCCAAAT-1	Matrix Fibroblasts
CTCCTAGAGAGGTACC-1	Matrix Fibroblasts
GCACATATCACTCCTG-1	Matrix Fibroblasts
GAACCTACAAAGAATC-1	Matrix Fibroblasts
AGCGTCGAGGCGATAC-1	Matrix Fibroblasts
GCATGCGGTCCTCCAT-1	Matrix Fibroblasts
GTGCATAAGGACACCA-1	Matrix Fibroblasts
TCAGATGAGTGTACGG-1	Matrix Fibroblasts
GACCTGGTCGGTTAAC-1	Matrix Fibroblasts
AGGTCATTCAAACAAG-1	Matrix Fibroblasts
GGCTCGAGTAAATGTG-1	Matrix Fibroblasts
TCAGGTACACCGCTAG-1	Matrix Fibroblasts
CCTCAGTAGGGTATCG-1	Matrix Fibroblasts
CGGAGTCTCATCTGTT-1	Matrix Fibroblasts
GTGCTTCAGAAGGACA-1	Matrix Fibroblasts
ACCTTTAAGAGCAATT-1	Matrix Fibroblasts
TAGCCGGCAATCCGAT-1	Matrix Fibroblasts
CTCTGGTTCTGCCAGG-1	Matrix Fibroblasts
ACGAGGAAGCTCTCGG-1	Matrix Fibroblasts
AGCGTATTCCTAGTGA-1	Matrix Fibroblasts
CTTGGCTAGCGTTCCG-1	Matrix Fibroblasts
CGCCAAGGTAACGTTC-1	Matrix Fibroblasts
CGATTGACACGTCTCT-1	Matrix Fibroblasts
AGGTCATCAGTACACT-1	Matrix Fibroblasts
CTGATCCGTTCAGGCC-1	Matrix Fibroblasts
ATCATGGCAGTAAGAT-1	Matrix Fibroblasts
AACTCAGGTAAATGTG-1	Matrix Fibroblasts
ACGATGTTCGCCAAAT-1	Matrix Fibroblasts
ATAACGCTCAATCTCT-1	Matrix Fibroblasts
GCTTGAACATGAACCT-1	Matrix Fibroblasts
GTACTTTAGGCTAGGT-1	Matrix Fibroblasts
CTGCGGAAGCCTTGAT-1	Matrix Fibroblasts
CGTCTACCACAGGAGT-1	Matrix Fibroblasts
CGGACTGGTTATGCGT-1	Matrix Fibroblasts
CCTTCGAAGGCACATG-1	Matrix Fibroblasts
CGGACTGCAAGCGATG-1	Matrix Fibroblasts
TACTTACTCGCTGATA-1	Matrix Fibroblasts
CGGCTAGCAAAGGAAG-1	Matrix Fibroblasts
TACTTGTCACTATCTT-1	Matrix Fibroblasts
GTTACAGCACGTAAGG-1	Matrix Fibroblasts
CGGAGCTGTATATGGA-1	Matrix Fibroblasts
CCTCTGATCTTCCTTC-1	Matrix Fibroblasts
AGGCCACCATGGTAGG-1	Matrix Fibroblasts
TGACTAGCACCACGTG-1	Matrix Fibroblasts
GCGAGAAGTATAGGTA-1	Matrix Fibroblasts
CATCGGGAGTAACCCT-1	Matrix Fibroblasts
GTTTCTAGTACTCTCC-1	Matrix Fibroblasts
GGATTACTCAAACCGT-1	Matrix Fibroblasts
CGCTGGATCCGCAAGC-1	Matrix Fibroblasts
TGAGCATGTCAGCTAT-1	Matrix Fibroblasts
TACTCGCCACGGCCAT-1	Matrix Fibroblasts
CGATTGACAGGTCCAC-1	Matrix Fibroblasts
GAATGAAAGGACATTA-1	Matrix Fibroblasts
AACCATGAGACAAGCC-1	Matrix Fibroblasts
ACTATCTCAGCCTGTG-1	Matrix Fibroblasts
CGTCACTGTCTAACGT-1	Matrix Fibroblasts
CTAGCCTTCGGTGTTA-1	Matrix Fibroblasts
TACTCGCGTGCATCTA-1	Matrix Fibroblasts
GACTGCGTCAACACGT-1	Matrix Fibroblasts
GCATGCGCAGACAGGT-1	Matrix Fibroblasts
CGTCTACTCAAGGTAA-1	Matrix Fibroblasts
AGCGTATTCAGCGACC-1	Matrix Fibroblasts
GAATAAGGTCTCTCTG-1	Matrix Fibroblasts
CCGGTAGCACGACTCG-1	Matrix Fibroblasts
GCTGCGAGTTCATGGT-1	Matrix Fibroblasts
CCTACACCAGTAACGG-1	Matrix Fibroblasts
AGTGGGACACATTTCT-1	Matrix Fibroblasts
GAAATGATCGGAATCT-1	Matrix Fibroblasts
CTGGTCTGTTTAGCTG-1	Matrix Fibroblasts
CGTGAGCCAACCGCCA-1	Matrix Fibroblasts
CATATGGGTTATCCGA-1	Matrix Fibroblasts
CTGAAACTCTAACTGG-1	Matrix Fibroblasts
CCATTCGGTCCATGAT-1	Matrix Fibroblasts
CGTCAGGTCACGACTA-1	Matrix Fibroblasts
ACACCAAGTTAAGATG-1	Matrix Fibroblasts
CTAGTGAAGGAATTAC-1	Matrix Fibroblasts
CAGTAACGTAGTGAAT-1	Matrix Fibroblasts
CTTAGGACAATGGTCT-1	Matrix Fibroblasts
TTAGGCAGTGGTCTCG-1	Matrix Fibroblasts
TTGCGTCGTCTGATCA-1	Matrix Fibroblasts
GGCCGATTCGTCACGG-1	Matrix Fibroblasts
GGTGAAGTCCAGGGCT-1	Matrix Fibroblasts
CTCCTAGTCTGAAAGA-1	Matrix Fibroblasts
TAGTTGGGTCGCGGTT-1	Matrix Fibroblasts
GCATGCGCAGTATAAG-1	Matrix Fibroblasts
GAAGCAGTCTGTCTCG-1	Matrix Fibroblasts
TGGTTAGGTTCCACGG-1	Matrix Fibroblasts
AGCTCCTCAAGAAAGG-1	Matrix Fibroblasts
TACCTATCATGGTCTA-1	Matrix Fibroblasts
CGTTAGACATGCAATC-1	Matrix Fibroblasts
TCTCTAACAAGTTGTC-1	Matrix Fibroblasts
GCTTGAACAGATGAGC-1	Matrix Fibroblasts
TATGCCCTCACTTATC-1	Matrix Fibroblasts
TGAGCATGTGAGCGAT-1	Matrix Fibroblasts
GGCGACTTCGGAATCT-1	Matrix Fibroblasts
ACGAGCCCATTAACCG-1	Matrix Fibroblasts
ACACTGAAGTACACCT-1	Matrix Fibroblasts
AGTAGTCCAGCTCGCA-1	Matrix Fibroblasts
CCGGTAGTCTGCTGTC-1	Matrix Fibroblasts
CTAGCCTTCTCGCTTG-1	Matrix Fibroblasts
CTCGGGACATCTGGTA-1	Matrix Fibroblasts
ACTGATGAGGAATCGC-1	Matrix Fibroblasts
ACGATACTCGCCATAA-1	Matrix Fibroblasts
AGATTGCCACACTGCG-1	Matrix Fibroblasts
TCAGCTCAGCTAAACA-1	Matrix Fibroblasts
GTGCATACAGCCTATA-1	Matrix Fibroblasts
GATGAGGAGATCACGG-1	Matrix Fibroblasts
CAACCTCCATCGGAAG-1	Matrix Fibroblasts
CCTACCAGTGCCTTGG-1	Matrix Fibroblasts
TTTACTGTCCACGACG-1	Matrix Fibroblasts
ACGCCGATCTCCTATA-1	Matrix Fibroblasts
CGAACATTCTGTTTGT-1	Matrix Fibroblasts
TAGTTGGTCACCAGGC-1	Matrix Fibroblasts
GACGCGTTCGGTGTTA-1	Matrix Fibroblasts
CTACGTCCATGCAACT-1	Matrix Fibroblasts
GGTGCGTAGAGCAATT-1	Matrix Fibroblasts
AGATCTGAGTGTGGCA-1	Matrix Fibroblasts
GATCGATGTTAGGGTG-1	Matrix Fibroblasts
TTCTACAAGACACTAA-1	Matrix Fibroblasts
ACACCGGAGGACCACA-1	Matrix Fibroblasts
GCAGTTACATCGACGC-1	Matrix Fibroblasts
AAGGAGCTCAGCTGGC-1	Matrix Fibroblasts
CTGCTGTCACCGGAAA-1	Matrix Fibroblasts
CGTAGCGGTCTAAACC-1	Matrix Fibroblasts
GCTCCTAGTTGGTAAA-1	Matrix Fibroblasts
ACGTCAACATCCAACA-1	Matrix Fibroblasts
ATTTCTGAGACCCACC-1	Matrix Fibroblasts
CGAACATTCAATCTCT-1	Matrix Fibroblasts
TCACGAAAGGCTCATT-1	Matrix Fibroblasts
TGAGCATAGTTGTAGA-1	Matrix Fibroblasts
TCGAGGCAGGACAGCT-1	Matrix Fibroblasts
CTCTAATAGGCAGTCA-1	Matrix Fibroblasts
ACTGCTCTCAGGATCT-1	Matrix Fibroblasts
TGGCCAGCACCAGGTC-1	Matrix Fibroblasts
AGAGCTTAGGTTACCT-1	Matrix Fibroblasts
TTGGAACAGCGATAGC-1	Matrix Fibroblasts
GTGCAGCGTTACAGAA-1	Matrix Fibroblasts
CGCGTTTTCGTTTAGG-1	Matrix Fibroblasts
GCCAAATGTTACCAGT-1	Matrix Fibroblasts
ATGAGGGAGCGTTCCG-1	Matrix Fibroblasts
CCGTTCATCAAGATCC-1	Matrix Fibroblasts
ATAAGAGTCACGCGGT-1	Matrix Fibroblasts
TAGGCATCACAGAGGT-1	Matrix Fibroblasts
GTGGGTCGTCAGAAGC-1	Matrix Fibroblasts
ACATACGGTAAAGTCA-1	Matrix Fibroblasts
CATTCGCGTGGTAACG-1	Matrix Fibroblasts
GTACGTACAAGGTGTG-1	Matrix Fibroblasts
CGTAGCGGTGGAAAGA-1	Matrix Fibroblasts
GCGCAGTTCAAAGACA-1	Matrix Fibroblasts
TGTGTTTAGGCGCTCT-1	Matrix Fibroblasts
TACGGATCAACGCACC-1	Matrix Fibroblasts
ACACCCTCAAGCGATG-1	Matrix Fibroblasts
TACTCGCTCGTTACAG-1	Matrix Fibroblasts
CCCAATCGTAGCGCAA-1	Matrix Fibroblasts
ATAGACCGTATAGGGC-1	Matrix Fibroblasts
CATGGCGAGGTACTCT-1	Matrix Fibroblasts
GTTCGGGAGTGGACGT-1	Matrix Fibroblasts
AGAATAGGTCCGCTGA-1	Matrix Fibroblasts
TACGGATTCTTTACGT-1	Matrix Fibroblasts
GATCGATGTAACGACG-1	Matrix Fibroblasts
ACGCAGCAGATACACA-1	Matrix Fibroblasts
TGGCCAGCAAGAAGAG-1	Matrix Fibroblasts
AAGCCGCAGTTCGCAT-1	Matrix Fibroblasts
CGTCTACTCTGATTCT-1	Matrix Fibroblasts
CGTGTAAGTTCCAACA-1	Matrix Fibroblasts
GAGCAGATCTATCCTA-1	Matrix Fibroblasts
GCGCAACGTACAGTTC-1	Matrix Fibroblasts
TTGCGTCCAGGAACGT-1	Matrix Fibroblasts
ATCCGAAAGAACAATC-1	Matrix Fibroblasts
TGAGGGATCCCATTAT-1	Matrix Fibroblasts
ACGATGTTCCTATGTT-1	Matrix Fibroblasts
CTAGTGACATGTTGAC-1	Matrix Fibroblasts
GGGTCTGCACCTCGGA-1	Matrix Fibroblasts
CGATCGGAGCTCCTCT-1	Matrix Fibroblasts
CTTTGCGCAGTATGCT-1	Matrix Fibroblasts
CGTAGGCTCTCCGGTT-1	Matrix Fibroblasts
CTAGAGTAGGACAGCT-1	Matrix Fibroblasts
TCAACGAGTCTGATCA-1	Matrix Fibroblasts
GTGGGTCAGTGGACGT-1	Matrix Fibroblasts
CTACCCAGTATTACCG-1	Matrix Fibroblasts
GGGCACTTCGCGATCG-1	Matrix Fibroblasts
GCAAACTCACCGATAT-1	Matrix Fibroblasts
ACGTCAATCGTTGACA-1	Matrix Fibroblasts
GTCAAGTGTATAATGG-1	Matrix Fibroblasts
TAGAGCTCACGGTAAG-1	Matrix Fibroblasts
GTAACTGGTATGCTTG-1	Matrix Fibroblasts
TCGCGAGGTAGCAAAT-1	Matrix Fibroblasts
AGTTGGTAGAGTGAGA-1	Matrix Fibroblasts
CGCTGGATCTTTAGGG-1	Matrix Fibroblasts
GATTCAGTCTCGCTTG-1	Matrix Fibroblasts
TGGACGCCATGTTCCC-1	Matrix Fibroblasts
GACAGAGCACTCGACG-1	Matrix Fibroblasts
TTTGCGCTCTAACGGT-1	Matrix Fibroblasts
CACAAACGTTACCGAT-1	Matrix Fibroblasts
AGGTCATGTAAAGTCA-1	Matrix Fibroblasts
AACTCCCAGTTACGGG-1	Matrix Fibroblasts
TGGGCGTCAGTATAAG-1	Matrix Fibroblasts
GAATAAGCACGTCAGC-1	Matrix Fibroblasts
GAACATCGTCTAGGTT-1	Matrix Fibroblasts
CTAACTTGTAAAGTCA-1	Matrix Fibroblasts
GGCGACTCAATGTTGC-1	Matrix Fibroblasts
AGCGTATGTGTGACCC-1	Matrix Fibroblasts
CATGCCTTCGCGTTTC-1	Matrix Fibroblasts
ATAAGAGTCTGGTATG-1	Matrix Fibroblasts
AGAGTGGAGAGAACAG-1	Matrix Fibroblasts
AGACGTTGTAAATGAC-1	Matrix Fibroblasts
TTGTAGGTCACCAGGC-1	Matrix Fibroblasts
GCTGCAGAGATGCCTT-1	Matrix Fibroblasts
CAAGAAATCGACCAGC-1	Matrix Fibroblasts
GTCAAGTGTCGACTAT-1	Matrix Fibroblasts
CGCTGGATCATGCTCC-1	Matrix Fibroblasts
CAACTAGCACATCCGG-1	Matrix Fibroblasts
AAGGTTCTCTGCTGTC-1	Matrix Fibroblasts
GGACATTCAGGCTGAA-1	Matrix Fibroblasts
GGGTTGCGTTGTTTGG-1	Matrix Fibroblasts
TGAAAGACACTGCCAG-1	Matrix Fibroblasts
CGGTTAAGTACGACCC-1	Matrix Fibroblasts
CGACCTTCAAGCTGAG-1	Matrix Fibroblasts
GTCATTTTCGGATGGA-1	Matrix Fibroblasts
TAAACCGAGATACACA-1	Matrix Fibroblasts
TCAGGTAAGAGTACAT-1	Matrix Fibroblasts
AGATCTGGTCTGATTG-1	Matrix Fibroblasts
GGACAAGGTGTGACCC-1	Matrix Fibroblasts
TTTCCTCTCCTGCTTG-1	Matrix Fibroblasts
TCTCTAACACAGATTC-1	Matrix Fibroblasts
GTCGGGTTCTGATTCT-1	Matrix Fibroblasts
GAATGAAGTGCTTCTC-1	Matrix Fibroblasts
GGCAATTCAAGCCTAT-1	Matrix Fibroblasts
CGTCAGGCAATGGAGC-1	Matrix Fibroblasts
GAAATGACAATAGAGT-1	Matrix Fibroblasts
CGTTGGGCAGGTTTCA-1	Matrix Fibroblasts
TCTGAGACAGACGCCT-1	Matrix Fibroblasts
GTCATTTGTAGTAGTA-1	Matrix Fibroblasts
CACACAAGTGGAAAGA-1	Matrix Fibroblasts
TTCGGTCGTCTCACCT-1	Matrix Fibroblasts
TCTCTAACAGCTTAAC-1	Matrix Fibroblasts
TACAGTGGTACTTGAC-1	Matrix Fibroblasts
TCGCGTTAGAGTCTGG-1	Matrix Fibroblasts
GCGACCATCTATCGCC-1	Matrix Fibroblasts
TCTTTCCTCAGCTCGG-1	Matrix Fibroblasts
CGAATGTCACTCTGTC-1	Matrix Fibroblasts
CTTAACTCAGATGAGC-1	Matrix Fibroblasts
CGTCACTGTGCAGACA-1	Matrix Fibroblasts
ATAAGAGAGCACACAG-1	Matrix Fibroblasts
GACGTGCAGTGACTCT-1	Matrix Fibroblasts
CAACCAATCTTGCAAG-1	Matrix Fibroblasts
GCGCAACAGGAGCGAG-1	Matrix Fibroblasts
TAGTTGGTCTACTATC-1	Matrix Fibroblasts
TCAATCTTCAGCTGGC-1	Matrix Fibroblasts
ATTGGACGTCACTTCC-1	Matrix Fibroblasts
GTAACTGAGACGACGT-1	Matrix Fibroblasts
AATCCAGAGCTAGTGG-1	Matrix Fibroblasts
CTCGAAATCTACTCAT-1	Matrix Fibroblasts
TAGAGCTCACGCGAAA-1	Matrix Fibroblasts
AAGCCGCTCTCTAAGG-1	Matrix Fibroblasts
GCTTCCATCCAGTAGT-1	Matrix Fibroblasts
TTAGGACCATTCCTGC-1	Matrix Fibroblasts
ACTGCTCGTAAGTGTA-1	Matrix Fibroblasts
TCTGAGAAGCGATAGC-1	Matrix Fibroblasts
CGGGTCAGTCTCTTTA-1	Matrix Fibroblasts
CCGGGATCATACGCTA-1	Matrix Fibroblasts
ATCTACTCACTGTCGG-1	Matrix Fibroblasts
AGAGTGGTCCAAAGTC-1	Matrix Fibroblasts
AGCGTATAGTAGTGCG-1	Matrix Fibroblasts
CTTGGCTCAAAGCAAT-1	Matrix Fibroblasts
GGGATGATCGGGAGTA-1	Matrix Fibroblasts
GTCAAGTCACGAGGTA-1	Matrix Fibroblasts
AACGTTGGTCAAAGAT-1	Matrix Fibroblasts
GGCGTGTGTAAGTGGC-1	Matrix Fibroblasts
CACCACTTCCCTTGCA-1	Matrix Fibroblasts
AGCCTAAAGCTGAAAT-1	Matrix Fibroblasts
TAAGTGCAGAGTGACC-1	Matrix Fibroblasts
TCGCGAGTCGTTTGCC-1	Matrix Fibroblasts
TGCACCTGTGCACGAA-1	Matrix Fibroblasts
GCGACCACAATGTAAG-1	Matrix Fibroblasts
CCTATTAAGAGCTATA-1	Matrix Fibroblasts
GCATACATCAGAAATG-1	Matrix Fibroblasts
TGCGCAGGTATAAACG-1	Matrix Fibroblasts
CTCGGAGCAATTGCTG-1	Matrix Fibroblasts
TACTCGCGTCCGTCAG-1	Matrix Fibroblasts
AGAGCGAAGCTCTCGG-1	Matrix Fibroblasts
GTGGGTCGTAGCTGCC-1	Matrix Fibroblasts
AGCCTAAGTCTGATCA-1	Matrix Fibroblasts
GGTGCGTAGAGTAATC-1	Matrix Fibroblasts
GATTCAGAGGCCCTTG-1	Matrix Fibroblasts
CTGCCTATCTTGTTTG-1	Matrix Fibroblasts
CATTATCCACCAGGTC-1	Matrix Fibroblasts
CTTCTCTAGACAAGCC-1	Matrix Fibroblasts
CTGGTCTCAGCATACT-1	Matrix Fibroblasts
AGTAGTCCAGACACTT-1	Matrix Fibroblasts
GTGCTTCTCCCTAATT-1	Matrix Fibroblasts
TACGGATGTAAATACG-1	Matrix Fibroblasts
GAAACTCGTAGAAAGG-1	Matrix Fibroblasts
GCTCTGTAGGGAACGG-1	Matrix Fibroblasts
TCTTCGGTCTGGTTCC-1	Matrix Fibroblasts
GGATGTTTCCCTCAGT-1	Matrix Fibroblasts
TGCTACCAGCTCCTTC-1	Matrix Fibroblasts
CCCTCCTTCGCATGGC-1	Matrix Fibroblasts
GCGGGTTGTGCAGACA-1	Matrix Fibroblasts
CGGACGTGTGGAAAGA-1	Matrix Fibroblasts
TTGAACGAGTTAGCGG-1	Matrix Fibroblasts
CTTTGCGAGGTTACCT-1	Matrix Fibroblasts
CATCGGGGTAGCCTCG-1	Matrix Fibroblasts
TGCACCTCACAGCCCA-1	Matrix Fibroblasts
GGAGCAACATGCTAGT-1	Matrix Fibroblasts
GGAACTTGTACATGTC-1	Matrix Fibroblasts
GACCAATGTAGCACGA-1	Matrix Fibroblasts
CGCCAAGGTGCGAAAC-1	Matrix Fibroblasts
CATGACACACATCTTT-1	Matrix Fibroblasts
TTCTACAAGGACTGGT-1	Matrix Fibroblasts
CTAATGGTCACATAGC-1	Matrix Fibroblasts
ACGAGCCCACTGTTAG-1	Matrix Fibroblasts
TAGAGCTCAAATCCGT-1	Matrix Fibroblasts
AAGTCTGGTCCAGTGC-1	Matrix Fibroblasts
CCTCAGTAGCGATGAC-1	Matrix Fibroblasts
TGCTACCCAACGCACC-1	Matrix Fibroblasts
TCGCGTTTCGAGGTAG-1	Matrix Fibroblasts
CTGATAGAGCGATAGC-1	Matrix Fibroblasts
CTTAACTTCCGTAGGC-1	Matrix Fibroblasts
GTACTCCGTAAACACA-1	Matrix Fibroblasts
TTCTACAGTTACGACT-1	Matrix Fibroblasts
GCTCCTAGTTGAACTC-1	Matrix Fibroblasts
TAGTTGGTCGCGATCG-1	Matrix Fibroblasts
GTCACAACAATCCAAC-1	Matrix Fibroblasts
ATTGGACTCGAACTGT-1	Matrix Fibroblasts
CTACATTCACAGTCGC-1	Matrix Fibroblasts
TGACTTTTCGGACAAG-1	Matrix Fibroblasts
CGCCAAGGTCTCTCGT-1	Matrix Fibroblasts
ACTGCTCTCTGAAAGA-1	Matrix Fibroblasts
GCAATCATCCGAATGT-1	Matrix Fibroblasts
GGCCGATAGACTAGGC-1	Matrix Fibroblasts
GGCTCGAAGAGCCCAA-1	Matrix Fibroblasts
CAAGGCCTCGCCGTGA-1	Matrix Fibroblasts
GTTAAGCAGAAAGTGG-1	Matrix Fibroblasts
AGGTCATCAGGGAGAG-1	Matrix Fibroblasts
TACACGAGTTGGAGGT-1	Matrix Fibroblasts
GATCGATGTTATGTGC-1	Matrix Fibroblasts
TCACGAAAGTAGATGT-1	Matrix Fibroblasts
TGACAACGTATCTGCA-1	Matrix Fibroblasts
CAAGATCTCAGTGTTG-1	Matrix Fibroblasts
AAACCTGAGCCAGAAC-1	Matrix Fibroblasts
CGAGCCATCCTAGAAC-1	Matrix Fibroblasts
TAGAGCTTCCGCGGTA-1	Matrix Fibroblasts
CTACGTCCATCGGTTA-1	Matrix Fibroblasts
GTGCAGCTCGCATGGC-1	Matrix Fibroblasts
TCCACACTCAGGTTCA-1	Matrix Fibroblasts
CAGAGAGCACATTAGC-1	Matrix Fibroblasts
TCGGGACTCTTATCTG-1	Matrix Fibroblasts
AGTAGTCCAGGTGCCT-1	Matrix Fibroblasts
GACCTGGAGTGTCTCA-1	Matrix Fibroblasts
TTCCCAGCAGTTAACC-1	Matrix Fibroblasts
AGAGCTTGTGTGTGCC-1	Matrix Fibroblasts
GGAATAACATGAAGTA-1	Matrix Fibroblasts
TGGCGCAGTACAAGTA-1	Matrix Fibroblasts
AGTGTCATCGTTGACA-1	Matrix Fibroblasts
ATGTGTGAGGATGCGT-1	Matrix Fibroblasts
TCATTACAGGCCCGTT-1	Matrix Fibroblasts
GACCTGGGTGATGCCC-1	Matrix Fibroblasts
GATCGTATCGGAAACG-1	Matrix Fibroblasts
CTAAGACCATTTCACT-1	Matrix Fibroblasts
CATATTCAGTGACTCT-1	Matrix Fibroblasts
AACCGCGAGCGTGAAC-1	Matrix Fibroblasts
ACTTACTTCCCAAGTA-1	Matrix Fibroblasts
GCGACCACATCACAAC-1	Matrix Fibroblasts
GCCTCTAAGAGTAAGG-1	Matrix Fibroblasts
CCTTACGGTGTGGCTC-1	Matrix Fibroblasts
ACAGCCGGTTATGCGT-1	Matrix Fibroblasts
CAGTCCTGTCTTCGTC-1	Matrix Fibroblasts
ATGAGGGTCAAAGACA-1	Matrix Fibroblasts
CACCACTCACGGTTTA-1	Matrix Fibroblasts
CTCGTACGTAAACGCG-1	Matrix Fibroblasts
TCAATCTTCCAGGGCT-1	Matrix Fibroblasts
ATTGGTGCAGACACTT-1	Matrix Fibroblasts
GGACGTCTCTGTACGA-1	Matrix Fibroblasts
GGGCACTGTACCGGCT-1	Matrix Fibroblasts
TAAGCGTAGGGCACTA-1	Matrix Fibroblasts
GCACTCTGTAGGCATG-1	Matrix Fibroblasts
CCTACACGTAAAGGAG-1	Matrix Fibroblasts
CTTAGGACAACCGCCA-1	Matrix Fibroblasts
CCACCTAGTTTCGCTC-1	Matrix Fibroblasts
AGACGTTAGGTGCACA-1	Matrix Fibroblasts
TCGAGGCAGTCTCAAC-1	Matrix Fibroblasts
TGGCTGGCAGGTCTCG-1	Matrix Fibroblasts
CCCAATCCATCAGTCA-1	Matrix Fibroblasts
TGACGGCCATGTTGAC-1	Matrix Fibroblasts
GGAAAGCCACACGCTG-1	Matrix Fibroblasts
AAATGCCAGTCTCAAC-1	Matrix Fibroblasts
CACATTTGTTAGATGA-1	Matrix Fibroblasts
CCTTTCTAGCTCCTTC-1	Matrix Fibroblasts
ATCCGAAAGAAGCCCA-1	Matrix Fibroblasts
GGCCGATCAAACGCGA-1	Matrix Fibroblasts
ACTATCTGTATATCCG-1	Matrix Fibroblasts
CGTCACTTCCTGCAGG-1	Matrix Fibroblasts
TTTATGCTCTTGTTTG-1	Matrix Fibroblasts
CGGACGTCAATGCCAT-1	Matrix Fibroblasts
AGCAGCCAGACCTAGG-1	Matrix Fibroblasts
CGTCTACGTAGGGTAC-1	Matrix Fibroblasts
TACGGGCGTAATAGCA-1	Matrix Fibroblasts
AAGGAGCTCAAACAAG-1	Matrix Fibroblasts
CATGACACATTAGCCA-1	Matrix Fibroblasts
CTCGAAAGTACAGCAG-1	Matrix Fibroblasts
CTCATTACATGACATC-1	Matrix Fibroblasts
CCTACACGTTCCGGCA-1	Matrix Fibroblasts
CTCACACGTGTCCTCT-1	Matrix Fibroblasts
CGCGGTAAGGCGCTCT-1	Matrix Fibroblasts
TAGGCATAGTAATCCC-1	Matrix Fibroblasts
CTTAGGAAGACTACAA-1	Matrix Fibroblasts
ACACTGACACGCGAAA-1	Matrix Fibroblasts
GTCACAACACAGGAGT-1	Matrix Fibroblasts
TCACAAGGTTTCCACC-1	Matrix Fibroblasts
TACGGTAAGATCGGGT-1	Matrix Fibroblasts
AGATTGCAGATCGGGT-1	Matrix Fibroblasts
GGCGACTAGGTGATTA-1	Matrix Fibroblasts
AGTGTCATCTTTAGTC-1	Matrix Fibroblasts
CCTCTGACATAAAGGT-1	Matrix Fibroblasts
ACACCCTCATGCGCAC-1	Matrix Fibroblasts
GTACGTATCCCGACTT-1	Matrix Fibroblasts
ACTGTCCTCTGTCTAT-1	Matrix Fibroblasts
CATGCCTGTACTCAAC-1	Matrix Fibroblasts
GGACAAGCATGGTTGT-1	Matrix Fibroblasts
ATCTGCCGTATCTGCA-1	Matrix Fibroblasts
TGCCCATAGAGAGCTC-1	Matrix Fibroblasts
GGGACCTTCGTAGGTT-1	Matrix Fibroblasts
CCTTCGAGTTTGTTTC-1	Matrix Fibroblasts
ACTGTCCTCTCGAGTA-1	Matrix Fibroblasts
GCAGCCACAATACGCT-1	Matrix Fibroblasts
GGCTGGTGTGGTACAG-1	Matrix Fibroblasts
ACGGAGATCTCCCTGA-1	Matrix Fibroblasts
CGTAGCGTCAGCTTAG-1	Matrix Fibroblasts
AAGCCGCTCGGTTCGG-1	Matrix Fibroblasts
CAACCTCTCTACTTAC-1	Matrix Fibroblasts
TACCTATTCTGCAGTA-1	Matrix Fibroblasts
TGATTTCGTCGAGATG-1	Matrix Fibroblasts
TATCTCAGTCTTGTCC-1	Matrix Fibroblasts
GTTCTCGGTTCGTCTC-1	Matrix Fibroblasts
GCTTGAAGTAGGCATG-1	Matrix Fibroblasts
CGGACACGTGTGACGA-1	Matrix Fibroblasts
TTGAACGAGGAGTCTG-1	Matrix Fibroblasts
CTGTTTATCCTTCAAT-1	Matrix Fibroblasts
GCATGATGTGCAACTT-1	Matrix Fibroblasts
AGATTGCAGGTGTTAA-1	Matrix Fibroblasts
CAACCAAAGATCCGAG-1	Matrix Fibroblasts
CTTAACTAGGCTCATT-1	Matrix Fibroblasts
TTCTTAGTCTCGCATC-1	Matrix Fibroblasts
GCAATCACACAACGTT-1	Matrix Fibroblasts
GTCGGGTAGTGTCCAT-1	Matrix Fibroblasts
GACGTTAGTCAATGTC-1	Matrix Fibroblasts
GAGCAGACACGAAGCA-1	Matrix Fibroblasts
CCTACCACATCCGGGT-1	Matrix Fibroblasts
TGCCCATTCTTGAGAC-1	Matrix Fibroblasts
TGACTTTTCTTCGAGA-1	Matrix Fibroblasts
TCTCTAAGTCAGGACA-1	Matrix Fibroblasts
CAGTCCTAGATCGGGT-1	Matrix Fibroblasts
GGTGTTACAGCTCGCA-1	Matrix Fibroblasts
GCATACAGTCGCATCG-1	Matrix Fibroblasts
GACCTGGGTTCCTCCA-1	Matrix Fibroblasts
GTCACGGAGATCCCGC-1	Matrix Fibroblasts
TACCTTACAGCGTCCA-1	Matrix Fibroblasts
GACAGAGGTTCCACTC-1	Matrix Fibroblasts
ACCAGTATCTCGATGA-1	Matrix Fibroblasts
GTACTCCGTTACCAGT-1	Matrix Fibroblasts
ACATGGTCACCTATCC-1	Matrix Fibroblasts
ACAGCTATCACCGTAA-1	Matrix Fibroblasts
TTTGGTTGTCATATCG-1	Matrix Fibroblasts
TATCAGGAGGGTCGAT-1	Matrix Fibroblasts
CGCTATCAGAGTACAT-1	Matrix Fibroblasts
GTCGTAAGTAAGTGGC-1	Matrix Fibroblasts
GGCCGATAGCTACCTA-1	Matrix Fibroblasts
ATCCGAATCATCGCTC-1	Matrix Fibroblasts
GGGTCTGCATCACGAT-1	Matrix Fibroblasts
GTGCTTCTCTTGCATT-1	Matrix Fibroblasts
TAGGCATTCGCTAGCG-1	Matrix Fibroblasts
CATATTCGTTAGAACA-1	Matrix Fibroblasts
AAGACCTAGTTAGCGG-1	Matrix Fibroblasts
CAGTCCTGTTCGTGAT-1	Matrix Fibroblasts
GCATGATGTAATTGGA-1	Matrix Fibroblasts
GGAGCAACAAGTTGTC-1	Matrix Fibroblasts
CTCGTACCACCGGAAA-1	Matrix Fibroblasts
CGATGGCTCTATGTGG-1	Matrix Fibroblasts
AGGGAGTCAAGCCTAT-1	Matrix Fibroblasts
TAGTGGTTCCGCAAGC-1	Matrix Fibroblasts
CGGCTAGAGGTGTGGT-1	Matrix Fibroblasts
TATGCCCTCAACCAAC-1	Matrix Fibroblasts
AAAGCAAGTAAGGGAA-1	Matrix Fibroblasts
TCAGCAAGTATTAGCC-1	Matrix Fibroblasts
TACTCGCTCGGCGCAT-1	Matrix Fibroblasts
CTACGTCTCTTGCAAG-1	Matrix Fibroblasts
GTGTGCGAGCCGATTT-1	Matrix Fibroblasts
CCCAATCAGTCGCCGT-1	Matrix Fibroblasts
CTTAACTGTGCAGACA-1	Matrix Fibroblasts
CAGTAACTCGCCATAA-1	Matrix Fibroblasts
AAACCTGTCTGATACG-1	Matrix Fibroblasts
CGAACATCAGATCCAT-1	Matrix Fibroblasts
TTAACTCCATCCGCGA-1	Matrix Fibroblasts
TCGTACCTCGGTCCGA-1	Matrix Fibroblasts
GATGAGGCACTACAGT-1	Matrix Fibroblasts
AGTAGTCTCTAGCACA-1	Matrix Fibroblasts
CGTGTCTCAGCTGTTA-1	Matrix Fibroblasts
ACTGAGTTCTGGTGTA-1	Matrix Fibroblasts
AAGACCTAGGAGTTGC-1	Matrix Fibroblasts
GCAGCCAAGCGATTCT-1	Matrix Fibroblasts
CCGTACTTCTGGTTCC-1	Matrix Fibroblasts
CAGCTGGTCTTCATGT-1	Matrix Fibroblasts
GTTCGGGTCAGGCAAG-1	Matrix Fibroblasts
CCTAGCTAGCCTCGTG-1	Matrix Fibroblasts
GCTTGAAGTTACCGAT-1	Matrix Fibroblasts
ACGGGTCTCAACACAC-1	Matrix Fibroblasts
CTAATGGAGCGCCTCA-1	Matrix Fibroblasts
GTCACGGAGACAAAGG-1	Matrix Fibroblasts
AGGCCACGTGTTGGGA-1	Matrix Fibroblasts
ACTATCTGTTCCGGCA-1	Matrix Fibroblasts
TTGTAGGTCATCATTC-1	Matrix Fibroblasts
CGTGTCTAGAAAGTGG-1	Matrix Fibroblasts
CGAATGTGTCTAGCGC-1	Matrix Fibroblasts
TTCCCAGGTAGGGTAC-1	Matrix Fibroblasts
CTGAAACTCCCAGGTG-1	Matrix Fibroblasts
AGCTTGAAGATTACCC-1	Matrix Fibroblasts
CAGAATCTCTTGTCAT-1	Matrix Fibroblasts
CATTCGCCAGCCTTTC-1	Matrix Fibroblasts
TTTACTGGTCTCCCTA-1	Matrix Fibroblasts
CAGCTGGTCTTGCCGT-1	Matrix Fibroblasts
TGAAAGACACCATCCT-1	Matrix Fibroblasts
CATGACATCTGGTATG-1	Matrix Fibroblasts
CTCAGAAAGGTGCTTT-1	Matrix Fibroblasts
AGAGTGGGTTGGGACA-1	Matrix Fibroblasts
CGTCCATAGAGGTAGA-1	Matrix Fibroblasts
CTACATTTCCCTGACT-1	Matrix Fibroblasts
CACACAACAAAGCGGT-1	Matrix Fibroblasts
CGAGAAGAGATCGATA-1	Matrix Fibroblasts
AGGCCACTCTGCTGTC-1	Matrix Fibroblasts
GCCAAATCACGCCAGT-1	Matrix Fibroblasts
TCGTACCTCTGCTGCT-1	Matrix Fibroblasts
AGACGTTAGTGCGTGA-1	Matrix Fibroblasts
GTGCATACAATGGTCT-1	Matrix Fibroblasts
ATCATGGTCGCACTCT-1	Matrix Fibroblasts
GATCGTACAATGGTCT-1	Matrix Fibroblasts
GTAACGTTCCGGGTGT-1	Matrix Fibroblasts
GTAGGCCCAATTGCTG-1	Matrix Fibroblasts
GTCAAGTGTATTCTCT-1	Matrix Fibroblasts
CACAGGCCAGGAACGT-1	Matrix Fibroblasts
CGGAGCTAGCCACCTG-1	Matrix Fibroblasts
GCAGTTATCGAACTGT-1	Matrix Fibroblasts
CGAGCCAAGCCCAGCT-1	Matrix Fibroblasts
GGTATTGCATGCAATC-1	Matrix Fibroblasts
GGCCGATAGTGAACAT-1	Matrix Fibroblasts
ACTATCTGTTAAAGAC-1	Matrix Fibroblasts
AGTCTTTAGAGTCGGT-1	Matrix Fibroblasts
GAAATGATCGATCCCT-1	Matrix Fibroblasts
TACACGAAGTGGAGTC-1	Matrix Fibroblasts
GCGCCAAGTAAACACA-1	Matrix Fibroblasts
TTAGGCAGTACAAGTA-1	Matrix Fibroblasts
TGAGCCGGTTGTGGCC-1	Matrix Fibroblasts
GGACAAGAGATGCGAC-1	Matrix Fibroblasts
GTCTTCGTCAGGCAAG-1	Matrix Fibroblasts
CCCAGTTTCAACACAC-1	Matrix Fibroblasts
TTGACTTAGGGAGTAA-1	Matrix Fibroblasts
ACTGATGAGATGGGTC-1	Matrix Fibroblasts
CGTGTCTAGCTGCAAG-1	Matrix Fibroblasts
ATTGGACTCTCTGCTG-1	Matrix Fibroblasts
GTGCAGCTCTAACTCT-1	Matrix Fibroblasts
GTCTTCGGTTGGGACA-1	Matrix Fibroblasts
GTATTCTCAATCGGTT-1	Matrix Fibroblasts
TACCTATGTTGCTCCT-1	Matrix Fibroblasts
ACATACGAGAGGGCTT-1	Matrix Fibroblasts
GACGTTAGTTGGACCC-1	Matrix Fibroblasts
CTAAGACGTAAGGATT-1	Matrix Fibroblasts
GCGGGTTAGAGATGAG-1	Matrix Fibroblasts
TATGCCCTCGGAGGTA-1	Matrix Fibroblasts
TCACGAACAGACAAGC-1	Matrix Fibroblasts
CTCATTATCTGAGGGA-1	Matrix Fibroblasts
ACTGAACTCGTCTGAA-1	Matrix Fibroblasts
CACACAAGTTCCATGA-1	Matrix Fibroblasts
CTTTGCGTCATGTCCC-1	Matrix Fibroblasts
CAAGAAAAGTGGAGTC-1	Matrix Fibroblasts
TTGGCAATCACCGTAA-1	Matrix Fibroblasts
ATGAGGGAGAGGGCTT-1	Matrix Fibroblasts
GACCAATTCGCACTCT-1	Matrix Fibroblasts
GCGACCATCCTCCTAG-1	Matrix Fibroblasts
GATTCAGTCGCGTTTC-1	Matrix Fibroblasts
ATCATGGGTTCATGGT-1	Matrix Fibroblasts
GGTGTTAAGCTGCCCA-1	Matrix Fibroblasts
TGAGCATGTATCGCAT-1	Matrix Fibroblasts
AACTCAGTCGTACCGG-1	Matrix Fibroblasts
TCACGAACACAGGTTT-1	Matrix Fibroblasts
CCGTTCAGTTGATTGC-1	Matrix Fibroblasts
TGCGCAGTCCTCATTA-1	Matrix Fibroblasts
TGACTAGGTCATTAGC-1	Matrix Fibroblasts
CACATTTGTGCACTTA-1	Matrix Fibroblasts
TGTTCCGTCCTTGACC-1	Matrix Fibroblasts
ACAGCCGAGCTAGTGG-1	Matrix Fibroblasts
TCGGGACTCAGTTGAC-1	Matrix Fibroblasts
TGCCCTACACATTAGC-1	Matrix Fibroblasts
ATCTACTGTAGATTAG-1	Matrix Fibroblasts
GACCAATGTGCACCAC-1	Matrix Fibroblasts
GATCTAGAGAATTGTG-1	Matrix Fibroblasts
CACACAAGTCGAATCT-1	Matrix Fibroblasts
TTTGGTTTCACTCCTG-1	Matrix Fibroblasts
GTACTCCGTAGCCTAT-1	Matrix Fibroblasts
GTAGTCAGTTTCGCTC-1	Matrix Fibroblasts
GAGTCCGTCTCGCTTG-1	Matrix Fibroblasts
GGGATGAGTCATGCCG-1	Matrix Fibroblasts
CATGACAGTCCGAAGA-1	Matrix Fibroblasts
TAGGCATTCCAGAAGG-1	Matrix Fibroblasts
CGACTTCCAAGTTAAG-1	Matrix Fibroblasts
GACGTTACATATGGTC-1	Matrix Fibroblasts
GCTCCTACACTTAACG-1	Matrix Fibroblasts
ACGTCAAAGAAACCAT-1	Matrix Fibroblasts
AACTCCCGTAATCACC-1	Matrix Fibroblasts
ATTATCCGTCTCATCC-1	Matrix Fibroblasts
CCGTTCATCCACGCAG-1	Matrix Fibroblasts
CTGGTCTCAAACGCGA-1	Matrix Fibroblasts
GACGGCTTCGATGAGG-1	Matrix Fibroblasts
GGGAATGGTCCAGTTA-1	Matrix Fibroblasts
TCCACACCAAGTAATG-1	Matrix Fibroblasts
GGACAGAGTACGCTGC-1	Matrix Fibroblasts
TGCTACCGTTCCACTC-1	Matrix Fibroblasts
TCGAGGCGTAAACGCG-1	Matrix Fibroblasts
GACCAATAGCCGGTAA-1	Matrix Fibroblasts
CTCGAAAGTCGTTGTA-1	Matrix Fibroblasts
TCTATTGGTTCATGGT-1	Matrix Fibroblasts
GGTATTGCATGTCCTC-1	Matrix Fibroblasts
TCTCTAAAGAAGGTTT-1	Matrix Fibroblasts
CGATCGGTCTTGTCAT-1	Matrix Fibroblasts
CCGGGATTCGTTTATC-1	Matrix Fibroblasts
CTCGTCAGTGGTTTCA-1	Matrix Fibroblasts
CTTTGCGCAGGAATCG-1	Matrix Fibroblasts
CTGATAGTCCCTCAGT-1	Matrix Fibroblasts
CGTCACTGTGCACCAC-1	Matrix Fibroblasts
GTTTCTATCATCATTC-1	Matrix Fibroblasts
TCAATCTCACCGCTAG-1	Matrix Fibroblasts
GACCAATGTTCACCTC-1	Matrix Fibroblasts
CGCCAAGCAGTGAGTG-1	Matrix Fibroblasts
CTGTGCTGTCCAGTTA-1	Matrix Fibroblasts
GTCTCGTCAGACGCCT-1	Matrix Fibroblasts
TTTGTCAAGAAACCTA-1	Matrix Fibroblasts
CAGCGACGTCTCTTTA-1	Matrix Fibroblasts
TCTTTCCCAAGCGTAG-1	Matrix Fibroblasts
AGTGGGATCCAAGTAC-1	Matrix Fibroblasts
AGATTGCGTACCGGCT-1	Matrix Fibroblasts
GGACATTCACGGTGTC-1	Matrix Fibroblasts
TGAGCATAGCAGGTCA-1	Matrix Fibroblasts
CTCGAGGTCGGAAATA-1	Matrix Fibroblasts
TGAGGGAAGCTTATCG-1	Matrix Fibroblasts
ACACTGACATATACGC-1	Matrix Fibroblasts
TCAATCTAGCTTATCG-1	Matrix Fibroblasts
TTGACTTAGTGGACGT-1	Matrix Fibroblasts
CTGAAACAGAAACCTA-1	Matrix Fibroblasts
CGGCTAGAGCTAGGCA-1	Matrix Fibroblasts
TTGAACGCAATGGAAT-1	Matrix Fibroblasts
TGGGCGTCAATGAAAC-1	Matrix Fibroblasts
CTCAGAAGTTCGGGCT-1	Matrix Fibroblasts
AGAGTGGAGGATATAC-1	Matrix Fibroblasts
CCATGTCAGTCGCCGT-1	Matrix Fibroblasts
CGTGTCTGTAAGTGTA-1	Matrix Fibroblasts
TTCTCCTTCACCTTAT-1	Matrix Fibroblasts
AGCGTCGGTAGGCATG-1	Matrix Fibroblasts
GATTCAGGTTACAGAA-1	Matrix Fibroblasts
AGAGTGGAGACCGGAT-1	Matrix Fibroblasts
CAGAGAGTCAGCTTAG-1	Matrix Fibroblasts
TGTGGTAAGATTACCC-1	Matrix Fibroblasts
GAACATCGTAAGAGAG-1	Matrix Fibroblasts
GAAGCAGTCGGCGGTT-1	Matrix Fibroblasts
CTAGCCTTCTTACCTA-1	Matrix Fibroblasts
CGGACGTTCAATACCG-1	Matrix Fibroblasts
CCTAGCTAGAGTTGGC-1	Matrix Fibroblasts
GAAACTCAGCAGATCG-1	Matrix Fibroblasts
CACAGGCTCCTATGTT-1	Matrix Fibroblasts
CAGATCAAGTACACCT-1	Matrix Fibroblasts
TGCCAAATCGGCTTGG-1	Matrix Fibroblasts
AACTCTTTCATAAAGG-1	Matrix Fibroblasts
CAGAATCAGTCCAGGA-1	Matrix Fibroblasts
ATCTACTTCAGCGATT-1	Matrix Fibroblasts
TATCAGGCAAGCGTAG-1	Matrix Fibroblasts
ACTGCTCTCAACCAAC-1	Matrix Fibroblasts
GTAACTGCACAGACAG-1	Matrix Fibroblasts
GTCACGGAGACACTAA-1	Matrix Fibroblasts
CCTTTCTGTTGTGGAG-1	Matrix Fibroblasts
GATGCTAAGTCCTCCT-1	Matrix Fibroblasts
CAGCCGATCCTTCAAT-1	Matrix Fibroblasts
TTGGCAAAGGCGATAC-1	Matrix Fibroblasts
TTAGGCATCACTCTTA-1	Matrix Fibroblasts
TTAGTTCAGGAATTAC-1	Matrix Fibroblasts
CTAACTTCAGCCTTGG-1	Matrix Fibroblasts
CGCGTTTTCACCTCGT-1	Matrix Fibroblasts
CATCGAAGTAAACACA-1	Matrix Fibroblasts
GGTGAAGGTCTCGTTC-1	Matrix Fibroblasts
ACTTTCAAGGCTACGA-1	Matrix Fibroblasts
GCATGATTCAGCCTAA-1	Matrix Fibroblasts
ACTTGTTGTACACCGC-1	Matrix Fibroblasts
TGGCTGGTCAGTTCGA-1	Matrix Fibroblasts
GATGCTACATGTCGAT-1	Matrix Fibroblasts
TTTGTCAGTGTCTGAT-1	Matrix Fibroblasts
CCGTGGAGTCTTTCAT-1	Matrix Fibroblasts
CTAATGGAGCACACAG-1	Matrix Fibroblasts
TTTGGTTGTAAGTGTA-1	Matrix Fibroblasts
GCAATCATCTCCAACC-1	Matrix Fibroblasts
TGTTCCGGTGAGCGAT-1	Matrix Fibroblasts
CGAATGTTCACCACCT-1	Matrix Fibroblasts
TCTGAGAAGCGCTCCA-1	Matrix Fibroblasts
CTTTGCGTCTCCAACC-1	Matrix Fibroblasts
CTAACTTGTGCCTGTG-1	Matrix Fibroblasts
GTCACGGTCGTGACAT-1	Matrix Fibroblasts
CTGCCTATCAGCAACT-1	Matrix Fibroblasts
CGATGGCAGCCTTGAT-1	Matrix Fibroblasts
GCTTGAAGTATATCCG-1	Matrix Fibroblasts
CTACATTTCCAGAGGA-1	Matrix Fibroblasts
GATCGCGCAGATGGCA-1	Matrix Fibroblasts
TCAGCAATCTTGACGA-1	Matrix Fibroblasts
AGATTGCGTGTGCCTG-1	Matrix Fibroblasts
CCAATCCTCCATGCTC-1	Matrix Fibroblasts
GGGATGAGTTGTCTTT-1	Matrix Fibroblasts
GATGAAAAGCATCATC-1	Matrix Fibroblasts
GGAGCAATCCCATTAT-1	Matrix Fibroblasts
TCTATTGAGAACTCGG-1	Matrix Fibroblasts
CCTAGCTGTCCGAACC-1	Matrix Fibroblasts
AAGTCTGGTACGCACC-1	Matrix Fibroblasts
CACATTTTCACTTACT-1	Matrix Fibroblasts
CTGGTCTTCAGCACAT-1	Matrix Fibroblasts
GGACATTTCTGATTCT-1	Matrix Fibroblasts
GTTACAGGTAGGACAC-1	Matrix Fibroblasts
TACTCGCTCATGCATG-1	Matrix Fibroblasts
CGTAGCGAGCAGACTG-1	Matrix Fibroblasts
ACGCAGCGTGAGGGTT-1	Matrix Fibroblasts
CCTCAGTAGCTGAAAT-1	Matrix Fibroblasts
CTAGTGAGTGCAACTT-1	Matrix Fibroblasts
CTACGTCTCTTGTATC-1	Matrix Fibroblasts
GAATAAGAGGACAGCT-1	Matrix Fibroblasts
TCATTTGTCTGCAAGT-1	Matrix Fibroblasts
GGCTGGTTCATCACCC-1	Matrix Fibroblasts
TTGCGTCAGACTTGAA-1	Matrix Fibroblasts
CTTCTCTTCAGAGGTG-1	Matrix Fibroblasts
ACGATACCAATGGACG-1	Matrix Fibroblasts
TGCACCTCAATGGATA-1	Matrix Fibroblasts
GCTGCAGAGTTGTCGT-1	Matrix Fibroblasts
TCACAAGAGACAGACC-1	Matrix Fibroblasts
AGAGTGGGTCTGATTG-1	Matrix Fibroblasts
GGTGCGTAGGTTCCTA-1	Matrix Fibroblasts
CTAGAGTGTGCAACTT-1	Matrix Fibroblasts
TGGCGCAAGGTCATCT-1	Matrix Fibroblasts
GTCTCGTCAATGGACG-1	Matrix Fibroblasts
TGTTCCGTCTAACCGA-1	AT1
GTCTTCGCAGTTCCCT-1	AT1
AGGTCATAGAAGGGTA-1	AT1
GGGTCTGCAGATCCAT-1	AT1
GAAGCAGCATGTCCTC-1	AT1
ATCACGACAAGTTAAG-1	AT1
GCGCAACCAACGATCT-1	AT1
ACACTGATCGACCAGC-1	AT1
CAGCTAAGTCGACTAT-1	AT1
ACTTACTCATCATCCC-1	AT1
GATGCTATCTTGCATT-1	AT1
CTGCTGTAGCGCCTTG-1	AT1
GTTCTCGAGGTGACCA-1	AT1
CGAGAAGGTAAGTTCC-1	AT1
ACTTACTGTGTCCTCT-1	AT1
CTCGTCACACCGATAT-1	AT1
GGACATTCACATTCGA-1	AT1
TGCCCATCAATTGCTG-1	AT1
CCTTTCTAGAATAGGG-1	AT1
CACTCCATCGGAATCT-1	AT1
GGATGTTGTGAAAGAG-1	AT1
TTGACTTAGAGACTTA-1	AT1
CATCAGATCCTATTCA-1	AT1
AAGACCTTCCGTAGGC-1	AT1
GTGTTAGGTCTGCGGT-1	AT1
TACTTACAGCCCAACC-1	AT1
ATGCGATGTCGGGTCT-1	AT1
ACCCACTGTACCGTAT-1	AT1
GACCAATTCCAGTAGT-1	AT1
GCTGCGAAGGCTAGGT-1	AT1
CCGTTCAAGCCACCTG-1	AT1
GATGAGGGTAGCTGCC-1	AT1
GGACAAGGTGTCTGAT-1	
GGGACCTAGAGTCTGG-1	
GCTGCTTTCGTCCAGG-1	
CTAGCCTAGTGAAGTT-1	
GCTCCTATCCTTGCCA-1	
GACGCGTCATCACGTA-1	
AAGGCAGGTCTAGAGG-1	
GATCGTAGTTCTGAAC-1	
TGAGCCGGTACAGACG-1	
GGCCGATAGCGTTCCG-1	
CTACATTCAAGTCATC-1	
CTACCCAAGACCTTTG-1	
AGATCTGAGATGCCTT-1	
AGAGTGGCACTGAAGG-1	
GCGCAACCACGAAACG-1	
AGAATAGAGCGTGTCC-1	
CGGAGTCCAGGAACGT-1	
CTGTTTAAGAAACGAG-1	
TTATGCTTCAACGGGA-1	
CGGAGCTAGGAGTACC-1	
TGAAAGACAATCCAAC-1	
GTGGGTCCACTTCGAA-1	
AGTTGGTGTCAATGTC-1	
TATCAGGCACCTCGGA-1	
CTACACCCACCGATAT-1	
CCATTCGGTTTGTGTG-1	
ACTGTCCAGGAGCGTT-1	
GCGAGAAGTTCGAATC-1	
CTCAGAAAGCGTGTCC-1	
CCTTCCCGTTAAGAAC-1	
GACGTGCAGGTAGCTG-1	
TCTGAGAAGCTGCAAG-1	
CGGAGCTTCCCAGGTG-1	
AAAGATGCATCACGAT-1	
CACACAACAGGTCGTC-1	
CCGTACTCAGCTGTGC-1	
GCAGCCATCGCGTAGC-1	
CTAACTTCAATAGCAA-1	
CCACTACTCTTATCTG-1	
TGGCGCACAGATCTGT-1	
CTCGTCACAGGCTCAC-1	
TTCTCAAAGTCTCGGC-1	
CTCAGAACATGTAGTC-1	
AACGTTGGTGCACTTA-1	
GGCAATTAGGACACCA-1	
TCTCTAATCTACGAGT-1	
AATCGGTTCCAGAAGG-1	
GACGTGCCACCAACCG-1	
GTTAAGCGTAGGAGTC-1	
GGGTCTGAGCGTCAAG-1	
AGCCTAAAGGCATGGT-1	
GTTTCTATCTTCGAGA-1	
GGACATTTCTTTAGGG-1	
CACCTTGCAAGGGTCA-1	
ACGTCAAAGAGACTAT-1	
CGTGAGCCAGACACTT-1	
ACTTACTAGTAGCCGA-1	
ATTACTCAGGGTTCCC-1	
ACATCAGGTGCACTTA-1	
CAGCTGGTCAGCAACT-1	
GAACATCGTATTCGTG-1	
GAAGCAGGTACAGTGG-1	
ATAAGAGCACAACGTT-1	
CGTGTCTGTCCAGTTA-1	
ACTGAACAGCGACGTA-1	
ACCGTAATCTGGCGTG-1	
GGCGACTAGATAGTCA-1	
TCGTACCTCCCTAATT-1	
AATCCAGCAGCTCCGA-1	
GCGGGTTCACCGATAT-1	
GGTGTTATCGCATGAT-1	
GCGGGTTGTTAGAACA-1	
CGAGAAGAGAGCCCAA-1	
AGCATACGTTAGGGTG-1	
CAACCTCTCTGGTATG-1	
CATATTCCAGCTCGCA-1	
TACCTTATCGATGAGG-1	
CAGCAGCGTTAAGGGC-1	
GTATCTTAGTTCGCAT-1	
ACGGAGACAGCTCGAC-1	
CTAATGGTCGGTCTAA-1	
GTCCTCAAGAAGGCCT-1	
TGAGAGGCACTTCTGC-1	
CGCGTTTGTGATGTGG-1	
GGCGTGTTCATCACCC-1	
GTCGGGTCAGGACCCT-1	
TAGTGGTTCGAACTGT-1	
GACGCGTGTGTGACCC-1	
AGAATAGGTGTGGTTT-1	
GATGAGGTCAGAGGTG-1	
GGGCATCGTAAGCACG-1	
GCTTGAAGTCGGATCC-1	
ATAACGCCATACCATG-1	
TCGAGGCTCTATCCTA-1	
GGGAATGCACCTCGGA-1	
CTAATGGCATCCGGGT-1	
ACACCAAGTTCCTCCA-1	
ACGATACAGGGTGTTG-1	
GACGTTACAAGTCTAC-1	
GGGTTGCAGCACACAG-1	
GGGCATCCAGCATACT-1	
CTCAGAAAGAAGGTTT-1	
GGCTCGAGTAGAGCTG-1	
TTCCCAGAGGTTACCT-1	
GAAGCAGAGCGAAGGG-1	
CAGATCACAGGTTTCA-1	
AGGTCCGGTCGCCATG-1	
ACATCAGAGAATAGGG-1	
ACACCGGGTTAAAGTG-1	
GCCAAATTCTCGTATT-1	
CAGCTGGCAATGGAAT-1	
ATAACGCTCGCACTCT-1	
AGCTCCTCATACGCCG-1	
GAAACTCTCCACGTGG-1	
CATCCACGTGGCAAAC-1	
CGAGCCAAGCGCCTCA-1	
CATCGAAGTGCACTTA-1	
CCTACCAAGACTAGGC-1	
CATCGGGCATCCAACA-1	
CGGGTCACAGTAGAGC-1	
GGGATGAAGAAGGTGA-1	
TACCTTAGTGAGGGTT-1	
AACTCAGTCACTTACT-1	
ACGATACAGCGTTCCG-1	
CAAGAAAAGTGACTCT-1	
AGTGAGGGTCATACTG-1	
TGTGGTAAGCTCTCGG-1	
CTTCTCTTCGCCAAAT-1	
CGGACTGAGGCTCATT-1	
AACCGCGTCTAGCACA-1	